CENSUS_TRACT_NAME,TOTAL_HOUSEHOLDS,STATE_NUM,COUNTY_NUM,TRACT_NUM,WHITE_NOT_HISPANIC_RENTERS,BIPOC_RENTERS,%_BIPOC_RENTERS
"Census Tract 1, Iron County, Michigan",136,26,71,100,125,11,8.088235294117647
"Census Tract 1, Manistee County, Michigan",169,26,101,100,153,16,9.467455621301776
"Census Tract 1, Schoolcraft County, Michigan",108,26,153,100,72,36,33.33333333333333
"Census Tract 1, Charlevoix County, Michigan",82,26,29,100,78,4,4.878048780487805
"Census Tract 1, Houghton County, Michigan",64,26,61,100,64,0,0.0
"Census Tract 1, Gladwin County, Michigan",81,26,51,100,81,0,0.0
"Census Tract 1, Genesee County, Michigan",426,26,49,100,13,413,96.94835680751174
"Census Tract 1, Kalamazoo County, Michigan",389,26,77,100,64,325,83.54755784061697
"Census Tract 1, Marquette County, Michigan",558,26,103,100,551,7,1.2544802867383513
"Census Tract 1, Iosco County, Michigan",402,26,69,100,311,91,22.63681592039801
"Census Tract 1, Alpena County, Michigan",183,26,7,100,183,0,0.0
"Census Tract 1, Clare County, Michigan",69,26,35,100,52,17,24.637681159420293
"Census Tract 1, Jackson County, Michigan",492,26,75,100,433,59,11.991869918699187
"Census Tract 1, Gratiot County, Michigan",216,26,57,100,203,13,6.018518518518518
"Census Tract 1, Keweenaw County, Michigan",130,26,83,100,130,0,0.0
"Census Tract 1, Ingham County, Michigan",201,26,65,100,107,94,46.766169154228855
"Census Tract 1, Kent County, Michigan",366,26,81,100,285,81,22.131147540983605
"Census Tract 1, Muskegon County, Michigan",1413,26,121,100,729,684,48.40764331210191
"Census Tract 1, Tuscola County, Michigan",357,26,157,100,340,17,4.761904761904762
"Census Tract 1, Isabella County, Michigan",143,26,73,100,133,10,6.993006993006993
"Census Tract 1, Baraga County, Michigan",332,26,13,100,271,61,18.373493975903614
"Census Tract 1, Saginaw County, Michigan",135,26,145,100,4,131,97.03703703703704
"Census Tract 1, Alcona County, Michigan",51,26,1,100,51,0,0.0
"Census Tract 1, Benzie County, Michigan",253,26,19,100,210,43,16.99604743083004
"Census Tract 1, Alger County, Michigan",284,26,3,100,257,27,9.507042253521126
"Census Tract 2, Isabella County, Michigan",244,26,73,200,208,36,14.754098360655737
"Census Tract 2, Houghton County, Michigan",189,26,61,200,176,13,6.878306878306878
"Census Tract 2, Benzie County, Michigan",97,26,19,200,85,12,12.371134020618557
"Census Tract 2, Gladwin County, Michigan",27,26,51,200,21,6,22.22222222222222
"Census Tract 2, Calhoun County, Michigan",746,26,25,200,398,348,46.64879356568365
"Census Tract 2, Kent County, Michigan",78,26,81,200,73,5,6.41025641025641
"Census Tract 2, Iosco County, Michigan",264,26,69,200,264,0,0.0
"Census Tract 2, Saginaw County, Michigan",296,26,145,200,9,287,96.95945945945947
"Census Tract 2, Charlevoix County, Michigan",94,26,29,200,94,0,0.0
"Census Tract 2, Marquette County, Michigan",352,26,103,200,344,8,2.272727272727273
"Census Tract 2, Iron County, Michigan",66,26,71,200,66,0,0.0
"Census Tract 2, Clare County, Michigan",35,26,35,200,35,0,0.0
"Census Tract 2, Gratiot County, Michigan",297,26,57,200,268,29,9.764309764309765
"Census Tract 2, Alpena County, Michigan",213,26,7,200,168,45,21.12676056338028
"Census Tract 2, Genesee County, Michigan",205,26,49,200,0,205,100.0
"Census Tract 2, Baraga County, Michigan",281,26,13,200,144,137,48.754448398576514
"Census Tract 2, Alger County, Michigan",125,26,3,200,104,21,16.8
"Census Tract 2, Schoolcraft County, Michigan",51,26,153,200,37,14,27.450980392156865
"Census Tract 2, Jackson County, Michigan",674,26,75,200,361,313,46.439169139465875
"Census Tract 2, Manistee County, Michigan",67,26,101,200,65,2,2.9850746268656714
"Census Tract 2, Tuscola County, Michigan",162,26,157,200,146,16,9.876543209876543
"Census Tract 2.01, Kalamazoo County, Michigan",833,26,77,201,655,178,21.368547418967587
"Census Tract 2.02, Kalamazoo County, Michigan",156,26,77,202,12,144,92.3076923076923
"Census Tract 3, Iosco County, Michigan",198,26,69,300,198,0,0.0
"Census Tract 3, Berrien County, Michigan",303,26,21,300,0,303,100.0
"Census Tract 3, Clare County, Michigan",99,26,35,300,99,0,0.0
"Census Tract 3, Gladwin County, Michigan",82,26,51,300,82,0,0.0
"Census Tract 3, Tuscola County, Michigan",186,26,157,300,159,27,14.516129032258066
"Census Tract 3, Benzie County, Michigan",107,26,19,300,96,11,10.2803738317757
"Census Tract 3, Manistee County, Michigan",73,26,101,300,73,0,0.0
"Census Tract 3, Gratiot County, Michigan",536,26,57,300,460,76,14.17910447761194
"Census Tract 3, Muskegon County, Michigan",678,26,121,300,238,440,64.89675516224189
"Census Tract 3, Houghton County, Michigan",497,26,61,300,375,122,24.547283702213278
"Census Tract 3, Alger County, Michigan",71,26,3,300,62,9,12.676056338028168
"Census Tract 3, Calhoun County, Michigan",451,26,25,300,179,272,60.310421286031044
"Census Tract 3, Schoolcraft County, Michigan",406,26,153,300,340,66,16.25615763546798
"Census Tract 3, Marquette County, Michigan",518,26,103,300,497,21,4.054054054054054
"Census Tract 3, Charlevoix County, Michigan",113,26,29,300,105,8,7.079646017699115
"Census Tract 3, Genesee County, Michigan",611,26,49,300,9,602,98.52700490998363
"Census Tract 3, Kalamazoo County, Michigan",877,26,77,300,60,817,93.15849486887116
"Census Tract 3, Kent County, Michigan",687,26,81,300,556,131,19.068413391557495
"Census Tract 3, Isabella County, Michigan",199,26,73,300,193,6,3.015075376884422
"Census Tract 3, Alpena County, Michigan",193,26,7,300,193,0,0.0
"Census Tract 3, Iron County, Michigan",312,26,71,300,303,9,2.8846153846153846
"Census Tract 4, Kent County, Michigan",171,26,81,400,162,9,5.263157894736842
"Census Tract 4, Iron County, Michigan",373,26,71,400,363,10,2.680965147453083
"Census Tract 4, Gratiot County, Michigan",0,26,57,400,0,0,
"Census Tract 4, Isabella County, Michigan",662,26,73,400,518,144,21.75226586102719
"Census Tract 4, Saginaw County, Michigan",302,26,145,400,130,172,56.95364238410596
"Census Tract 4, Ingham County, Michigan",400,26,65,400,256,144,36.0
"Census Tract 4, Genesee County, Michigan",311,26,49,400,0,311,100.0
"Census Tract 4, Clare County, Michigan",255,26,35,400,255,0,0.0
"Census Tract 4, Alpena County, Michigan",415,26,7,400,415,0,0.0
"Census Tract 4, Gladwin County, Michigan",135,26,51,400,135,0,0.0
"Census Tract 4, Berrien County, Michigan",1147,26,21,400,95,1052,91.71752397558849
"Census Tract 4, Manistee County, Michigan",144,26,101,400,96,48,33.33333333333333
"Census Tract 4, Marquette County, Michigan",322,26,103,400,276,46,14.285714285714285
"Census Tract 4, Benzie County, Michigan",158,26,19,400,158,0,0.0
"Census Tract 4, Jackson County, Michigan",558,26,75,400,395,163,29.211469534050178
"Census Tract 4, Charlevoix County, Michigan",117,26,29,400,103,14,11.965811965811966
"Census Tract 4, Iosco County, Michigan",500,26,69,400,421,79,15.8
"Census Tract 4, Houghton County, Michigan",245,26,61,400,241,4,1.6326530612244898
"Census Tract 4, Tuscola County, Michigan",154,26,157,400,154,0,0.0
"Census Tract 4.01, Muskegon County, Michigan",579,26,121,401,222,357,61.6580310880829
"Census Tract 4.02, Muskegon County, Michigan",155,26,121,402,69,86,55.483870967741936
"Census Tract 5, Clare County, Michigan",85,26,35,500,77,8,9.411764705882353
"Census Tract 5, Gladwin County, Michigan",134,26,51,500,114,20,14.925373134328357
"Census Tract 5, Genesee County, Michigan",214,26,49,500,0,214,100.0
"Census Tract 5, Kent County, Michigan",148,26,81,500,118,30,20.27027027027027
"Census Tract 5, Jackson County, Michigan",263,26,75,500,185,78,29.65779467680608
"Census Tract 5, Muskegon County, Michigan",950,26,121,500,333,617,64.94736842105263
"Census Tract 5, Marquette County, Michigan",59,26,103,500,54,5,8.47457627118644
"Census Tract 5, Benzie County, Michigan",84,26,19,500,67,17,20.238095238095237
"Census Tract 5, Kalamazoo County, Michigan",1070,26,77,500,435,635,59.345794392523366
"Census Tract 5, Gratiot County, Michigan",1014,26,57,500,916,98,9.664694280078894
"Census Tract 5, Iosco County, Michigan",530,26,69,500,481,49,9.245283018867925
"Census Tract 5, Calhoun County, Michigan",509,26,25,500,236,273,53.63457760314342
"Census Tract 5, Houghton County, Michigan",302,26,61,500,259,43,14.23841059602649
"Census Tract 5, Manistee County, Michigan",95,26,101,500,83,12,12.631578947368421
"Census Tract 5, Berrien County, Michigan",306,26,21,500,0,306,100.0
"Census Tract 5, Isabella County, Michigan",718,26,73,500,631,87,12.116991643454039
"Census Tract 5, Tuscola County, Michigan",296,26,157,500,290,6,2.027027027027027
"Census Tract 5, Iron County, Michigan",118,26,71,500,118,0,0.0
"Census Tract 5, Charlevoix County, Michigan",35,26,29,500,31,4,11.428571428571429
"Census Tract 5, Alpena County, Michigan",422,26,7,500,408,14,3.3175355450236967
"Census Tract 6, Calhoun County, Michigan",481,26,25,600,189,292,60.70686070686071
"Census Tract 6, Marquette County, Michigan",704,26,103,600,580,124,17.613636363636363
"Census Tract 6, Gladwin County, Michigan",78,26,51,600,72,6,7.6923076923076925
"Census Tract 6, Ingham County, Michigan",784,26,65,600,418,366,46.683673469387756
"Census Tract 6, Isabella County, Michigan",1409,26,73,600,1199,210,14.9041873669269
"Census Tract 6, Iosco County, Michigan",124,26,69,600,120,4,3.225806451612903
"Census Tract 6, Jackson County, Michigan",462,26,75,600,285,177,38.311688311688314
"Census Tract 6, Kent County, Michigan",73,26,81,600,73,0,0.0
"Census Tract 6, Gratiot County, Michigan",528,26,57,600,388,140,26.515151515151516
"Census Tract 6, Houghton County, Michigan",840,26,61,600,823,17,2.0238095238095237
"Census Tract 6, Tuscola County, Michigan",699,26,157,600,666,33,4.721030042918455
"Census Tract 6, Clare County, Michigan",556,26,35,600,531,25,4.496402877697841
"Census Tract 6, Manistee County, Michigan",47,26,101,600,47,0,0.0
"Census Tract 6, Alpena County, Michigan",439,26,7,600,439,0,0.0
"Census Tract 6, Berrien County, Michigan",630,26,21,600,90,540,85.71428571428571
"Census Tract 6, Saginaw County, Michigan",221,26,145,600,35,186,84.16289592760181
"Census Tract 6, Kalamazoo County, Michigan",1574,26,77,600,1176,398,25.285895806861497
"Census Tract 6, Genesee County, Michigan",317,26,49,600,13,304,95.89905362776025
"Census Tract 6.01, Muskegon County, Michigan",246,26,121,601,68,178,72.35772357723577
"Census Tract 7, Iosco County, Michigan",117,26,69,700,113,4,3.418803418803419
"Census Tract 7, Tuscola County, Michigan",108,26,157,700,105,3,2.7777777777777777
"Census Tract 7, Berrien County, Michigan",129,26,21,700,65,64,49.6124031007752
"Census Tract 7, Houghton County, Michigan",73,26,61,700,73,0,0.0
"Census Tract 7, Gratiot County, Michigan",254,26,57,700,237,17,6.692913385826772
"Census Tract 7, Genesee County, Michigan",390,26,49,700,0,390,100.0
"Census Tract 7, Kent County, Michigan",233,26,81,700,95,138,59.227467811158796
"Census Tract 7, Manistee County, Michigan",216,26,101,700,196,20,9.25925925925926
"Census Tract 7, Marquette County, Michigan",951,26,103,700,895,56,5.888538380651945
"Census Tract 7, Saginaw County, Michigan",243,26,145,700,11,232,95.47325102880659
"Census Tract 7, Alpena County, Michigan",362,26,7,700,342,20,5.524861878453039
"Census Tract 7, Calhoun County, Michigan",323,26,25,700,229,94,29.102167182662537
"Census Tract 7, Ingham County, Michigan",741,26,65,700,365,376,50.742240215924426
"Census Tract 7, Gladwin County, Michigan",587,26,51,700,577,10,1.7035775127768313
"Census Tract 7, Clare County, Michigan",93,26,35,700,93,0,0.0
"Census Tract 7, Isabella County, Michigan",2167,26,73,700,1827,340,15.689893862482695
"Census Tract 8, Calhoun County, Michigan",404,26,25,800,221,183,45.2970297029703
"Census Tract 8, Tuscola County, Michigan",312,26,157,800,312,0,0.0
"Census Tract 8, Ingham County, Michigan",678,26,65,800,509,169,24.926253687315633
"Census Tract 8, Saginaw County, Michigan",278,26,145,800,25,253,91.00719424460432
"Census Tract 8, Muskegon County, Michigan",618,26,121,800,367,251,40.614886731391586
"Census Tract 8, Berrien County, Michigan",983,26,21,800,762,221,22.482197355035606
"Census Tract 8, Iosco County, Michigan",97,26,69,800,97,0,0.0
"Census Tract 8, Gladwin County, Michigan",521,26,51,800,496,25,4.798464491362764
"Census Tract 8, Kent County, Michigan",687,26,81,800,387,300,43.66812227074236
"Census Tract 8, Alpena County, Michigan",383,26,7,800,379,4,1.0443864229765014
"Census Tract 8, Isabella County, Michigan",728,26,73,800,537,191,26.236263736263737
"Census Tract 8, Charlevoix County, Michigan",146,26,29,800,131,15,10.273972602739725
"Census Tract 8, Gratiot County, Michigan",364,26,57,800,351,13,3.571428571428571
"Census Tract 8, Jackson County, Michigan",555,26,75,800,363,192,34.5945945945946
"Census Tract 8, Manistee County, Michigan",358,26,101,800,311,47,13.128491620111731
"Census Tract 8, Clare County, Michigan",119,26,35,800,119,0,0.0
"Census Tract 8, Houghton County, Michigan",1494,26,61,800,1005,489,32.730923694779115
"Census Tract 8, Genesee County, Michigan",185,26,49,800,0,185,100.0
"Census Tract 9, Alpena County, Michigan",202,26,7,900,202,0,0.0
"Census Tract 9, Muskegon County, Michigan",346,26,121,900,250,96,27.74566473988439
"Census Tract 9, Genesee County, Michigan",285,26,49,900,31,254,89.12280701754386
"Census Tract 9, Charlevoix County, Michigan",74,26,29,900,58,16,21.62162162162162
"Census Tract 9, Berrien County, Michigan",482,26,21,900,343,139,28.838174273858918
"Census Tract 9, Saginaw County, Michigan",807,26,145,900,60,747,92.56505576208178
"Census Tract 9, Tuscola County, Michigan",551,26,157,900,476,75,13.611615245009073
"Census Tract 9, Gladwin County, Michigan",23,26,51,900,23,0,0.0
"Census Tract 9, Houghton County, Michigan",555,26,61,900,537,18,3.2432432432432434
"Census Tract 9, Calhoun County, Michigan",570,26,25,900,439,131,22.982456140350877
"Census Tract 9, Iosco County, Michigan",108,26,69,900,108,0,0.0
"Census Tract 9, Isabella County, Michigan",296,26,73,900,269,27,9.121621621621621
"Census Tract 9, Clare County, Michigan",140,26,35,900,135,5,3.571428571428571
"Census Tract 9, Jackson County, Michigan",568,26,75,900,353,215,37.852112676056336
"Census Tract 9, Manistee County, Michigan",392,26,101,900,352,40,10.204081632653061
"Census Tract 9, Kalamazoo County, Michigan",122,26,77,900,53,69,56.557377049180324
"Census Tract 9, Kent County, Michigan",581,26,81,900,375,206,35.45611015490533
"Census Tract 9, Gratiot County, Michigan",235,26,57,900,216,19,8.085106382978724
"Census Tract 10, Gratiot County, Michigan",419,26,57,1000,371,48,11.455847255369928
"Census Tract 10, Saginaw County, Michigan",665,26,145,1000,35,630,94.73684210526315
"Census Tract 10, Berrien County, Michigan",128,26,21,1000,128,0,0.0
"Census Tract 10, Kent County, Michigan",716,26,81,1000,430,286,39.94413407821229
"Census Tract 10, Ingham County, Michigan",424,26,65,1000,347,77,18.160377358490564
"Census Tract 10, Clare County, Michigan",139,26,35,1000,139,0,0.0
"Census Tract 10, Tuscola County, Michigan",260,26,157,1000,243,17,6.538461538461539
"Census Tract 10, Houghton County, Michigan",173,26,61,1000,170,3,1.7341040462427744
"Census Tract 10, Calhoun County, Michigan",654,26,25,1000,303,351,53.669724770642205
"Census Tract 10, Jackson County, Michigan",524,26,75,1000,246,278,53.05343511450382
"Census Tract 10, Muskegon County, Michigan",43,26,121,1000,38,5,11.627906976744185
"Census Tract 10, Kalamazoo County, Michigan",1200,26,77,1000,437,763,63.583333333333336
"Census Tract 10, Genesee County, Michigan",313,26,49,1000,21,292,93.29073482428115
"Census Tract 10, Charlevoix County, Michigan",134,26,29,1000,115,19,14.17910447761194
"Census Tract 10, Cass County, Michigan",153,26,27,1000,153,0,0.0
"Census Tract 11, Genesee County, Michigan",364,26,49,1100,0,364,100.0
"Census Tract 11, Marquette County, Michigan",69,26,103,1100,69,0,0.0
"Census Tract 11, Charlevoix County, Michigan",209,26,29,1100,197,12,5.741626794258373
"Census Tract 11, Cass County, Michigan",289,26,27,1100,289,0,0.0
"Census Tract 11, Tuscola County, Michigan",186,26,157,1100,185,1,0.5376344086021506
"Census Tract 11, Berrien County, Michigan",126,26,21,1100,126,0,0.0
"Census Tract 11, Jackson County, Michigan",583,26,75,1100,133,450,77.18696397941682
"Census Tract 11, Saginaw County, Michigan",639,26,145,1100,49,590,92.33176838810641
"Census Tract 11, Calhoun County, Michigan",877,26,25,1100,461,416,47.43443557582668
"Census Tract 11, Kalamazoo County, Michigan",291,26,77,1100,188,103,35.39518900343643
"Census Tract 11.01, Kent County, Michigan",983,26,81,1101,341,642,65.31027466937945
"Census Tract 11.02, Kent County, Michigan",1050,26,81,1102,524,526,50.095238095238095
"Census Tract 12, Charlevoix County, Michigan",146,26,29,1200,134,12,8.21917808219178
"Census Tract 12, Kent County, Michigan",481,26,81,1200,325,156,32.432432432432435
"Census Tract 12, Kalamazoo County, Michigan",235,26,77,1200,235,0,0.0
"Census Tract 12, Calhoun County, Michigan",182,26,25,1200,96,86,47.25274725274725
"Census Tract 12, Ingham County, Michigan",485,26,65,1200,256,229,47.21649484536082
"Census Tract 12, Genesee County, Michigan",404,26,49,1200,18,386,95.54455445544554
"Census Tract 12, Cass County, Michigan",168,26,27,1200,148,20,11.904761904761903
"Census Tract 12, Muskegon County, Michigan",390,26,121,1200,47,343,87.94871794871794
"Census Tract 12, Marquette County, Michigan",245,26,103,1200,201,44,17.959183673469386
"Census Tract 12, Saginaw County, Michigan",601,26,145,1200,232,369,61.39767054908486
"Census Tract 12, Jackson County, Michigan",326,26,75,1200,225,101,30.981595092024538
"Census Tract 12, Tuscola County, Michigan",282,26,157,1200,272,10,3.546099290780142
"Census Tract 13, Charlevoix County, Michigan",294,26,29,1300,253,41,13.945578231292515
"Census Tract 13, Calhoun County, Michigan",646,26,25,1300,384,262,40.55727554179567
"Census Tract 13, Berrien County, Michigan",229,26,21,1300,176,53,23.144104803493452
"Census Tract 13, Clare County, Michigan",495,26,35,1300,452,43,8.686868686868687
"Census Tract 13, Saginaw County, Michigan",554,26,145,1300,294,260,46.931407942238266
"Census Tract 13, Kalamazoo County, Michigan",324,26,77,1300,217,107,33.0246913580247
"Census Tract 13, Muskegon County, Michigan",577,26,121,1300,34,543,94.10745233968805
"Census Tract 13, Marquette County, Michigan",207,26,103,1300,204,3,1.4492753623188406
"Census Tract 13, Tuscola County, Michigan",274,26,157,1300,274,0,0.0
"Census Tract 13, Kent County, Michigan",823,26,81,1300,344,479,58.201701093560146
"Census Tract 13, Genesee County, Michigan",309,26,49,1300,40,269,87.05501618122977
"Census Tract 13, Jackson County, Michigan",312,26,75,1300,123,189,60.57692307692307
"Census Tract 14, Charlevoix County, Michigan",82,26,29,1400,82,0,0.0
"Census Tract 14, Kent County, Michigan",748,26,81,1400,558,190,25.40106951871658
"Census Tract 14, Berrien County, Michigan",500,26,21,1400,369,131,26.200000000000003
"Census Tract 14, Genesee County, Michigan",165,26,49,1400,8,157,95.15151515151516
"Census Tract 14, Calhoun County, Michigan",595,26,25,1400,426,169,28.403361344537814
"Census Tract 14, Saginaw County, Michigan",325,26,145,1400,172,153,47.07692307692308
"Census Tract 14.02, Muskegon County, Michigan",613,26,121,1402,109,504,82.21859706362153
"Census Tract 15, Charlevoix County, Michigan",674,26,29,1500,652,22,3.2640949554896146
"Census Tract 15, Calhoun County, Michigan",161,26,25,1500,112,49,30.434782608695656
"Census Tract 15, Cass County, Michigan",198,26,27,1500,182,16,8.080808080808081
"Census Tract 15, Genesee County, Michigan",216,26,49,1500,50,166,76.85185185185185
"Census Tract 15, Berrien County, Michigan",532,26,21,1500,483,49,9.210526315789473
"Census Tract 15, Marquette County, Michigan",48,26,103,1500,48,0,0.0
"Census Tract 15, Kent County, Michigan",883,26,81,1500,537,346,39.1845979614949
"Census Tract 15, Muskegon County, Michigan",245,26,121,1500,207,38,15.510204081632653
"Census Tract 15, Saginaw County, Michigan",537,26,145,1500,359,178,33.14711359404097
"Census Tract 15.01, Kalamazoo County, Michigan",353,26,77,1501,217,136,38.52691218130311
"Census Tract 15.02, Kalamazoo County, Michigan",1035,26,77,1502,693,342,33.04347826086956
"Census Tract 15.03, Kalamazoo County, Michigan",710,26,77,1503,542,168,23.661971830985916
"Census Tract 15.04, Kalamazoo County, Michigan",254,26,77,1504,233,21,8.267716535433072
"Census Tract 15.06, Kalamazoo County, Michigan",2535,26,77,1506,1937,598,23.589743589743588
"Census Tract 15.07, Kalamazoo County, Michigan",2090,26,77,1507,1322,768,36.74641148325359
"Census Tract 16, Cass County, Michigan",271,26,27,1600,187,84,30.996309963099634
"Census Tract 16, Saginaw County, Michigan",821,26,145,1600,567,254,30.937880633373933
"Census Tract 16, Calhoun County, Michigan",205,26,25,1600,142,63,30.73170731707317
"Census Tract 16, Genesee County, Michigan",588,26,49,1600,281,307,52.21088435374149
"Census Tract 16, Muskegon County, Michigan",80,26,121,1600,80,0,0.0
"Census Tract 16, Kent County, Michigan",950,26,81,1600,599,351,36.94736842105264
"Census Tract 16, Berrien County, Michigan",50,26,21,1600,42,8,16.0
"Census Tract 16, Marquette County, Michigan",160,26,103,1600,160,0,0.0
"Census Tract 16.01, Kalamazoo County, Michigan",454,26,77,1601,269,185,40.7488986784141
"Census Tract 16.03, Kalamazoo County, Michigan",196,26,77,1603,169,27,13.77551020408163
"Census Tract 16.04, Kalamazoo County, Michigan",364,26,77,1604,266,98,26.923076923076923
"Census Tract 17, Berrien County, Michigan",149,26,21,1700,149,0,0.0
"Census Tract 17, Marquette County, Michigan",283,26,103,1700,277,6,2.1201413427561837
"Census Tract 17, Saginaw County, Michigan",603,26,145,1700,260,343,56.882255389718075
"Census Tract 17, Cass County, Michigan",318,26,27,1700,300,18,5.660377358490567
"Census Tract 17, Genesee County, Michigan",326,26,49,1700,0,326,100.0
"Census Tract 17, Muskegon County, Michigan",177,26,121,1700,140,37,20.903954802259886
"Census Tract 17, Calhoun County, Michigan",303,26,25,1700,226,77,25.412541254125415
"Census Tract 17, Kent County, Michigan",560,26,81,1700,444,116,20.714285714285715
"Census Tract 17.01, Kalamazoo County, Michigan",694,26,77,1701,501,193,27.80979827089337
"Census Tract 17.02, Kalamazoo County, Michigan",996,26,77,1702,620,376,37.75100401606426
"Census Tract 17.03, Ingham County, Michigan",868,26,65,1703,316,552,63.594470046082954
"Census Tract 18, Berrien County, Michigan",172,26,21,1800,172,0,0.0
"Census Tract 18, Muskegon County, Michigan",205,26,121,1800,190,15,7.317073170731707
"Census Tract 18, Saginaw County, Michigan",411,26,145,1800,178,233,56.69099756690997
"Census Tract 18, Calhoun County, Michigan",1700,26,25,1800,1218,482,28.352941176470587
"Census Tract 18, Genesee County, Michigan",539,26,49,1800,29,510,94.61966604823748
"Census Tract 18, Cass County, Michigan",329,26,27,1800,282,47,14.285714285714285
"Census Tract 18, Marquette County, Michigan",245,26,103,1800,211,34,13.877551020408163
"Census Tract 18, Kent County, Michigan",1034,26,81,1800,958,76,7.35009671179884
"Census Tract 18.01, Kalamazoo County, Michigan",484,26,77,1801,417,67,13.842975206611571
"Census Tract 18.02, Kalamazoo County, Michigan",972,26,77,1802,654,318,32.71604938271605
"Census Tract 18.03, Kalamazoo County, Michigan",266,26,77,1803,206,60,22.55639097744361
"Census Tract 19, Calhoun County, Michigan",207,26,25,1900,143,64,30.917874396135264
"Census Tract 19, Marquette County, Michigan",271,26,103,1900,269,2,0.7380073800738007
"Census Tract 19, Cass County, Michigan",532,26,27,1900,367,165,31.015037593984964
"Census Tract 19, Berrien County, Michigan",98,26,21,1900,86,12,12.244897959183673
"Census Tract 19, Genesee County, Michigan",555,26,49,1900,207,348,62.70270270270271
"Census Tract 19, Kent County, Michigan",1045,26,81,1900,620,425,40.66985645933015
"Census Tract 19, Saginaw County, Michigan",250,26,145,1900,116,134,53.6
"Census Tract 19.01, Muskegon County, Michigan",256,26,121,1901,136,120,46.875
"Census Tract 19.02, Muskegon County, Michigan",541,26,121,1902,494,47,8.687615526802219
"Census Tract 19.05, Kalamazoo County, Michigan",1229,26,77,1905,1002,227,18.470301057770545
"Census Tract 19.06, Kalamazoo County, Michigan",1423,26,77,1906,1204,219,15.390021082220661
"Census Tract 19.07, Kalamazoo County, Michigan",794,26,77,1907,649,145,18.261964735516372
"Census Tract 20, Marquette County, Michigan",242,26,103,2000,242,0,0.0
"Census Tract 20, Kent County, Michigan",1356,26,81,2000,963,393,28.98230088495575
"Census Tract 20, Ingham County, Michigan",849,26,65,2000,482,367,43.227326266195526
"Census Tract 20, Muskegon County, Michigan",147,26,121,2000,62,85,57.82312925170068
"Census Tract 20, Cass County, Michigan",350,26,27,2000,250,100,28.57142857142857
"Census Tract 20, Genesee County, Michigan",130,26,49,2000,0,130,100.0
"Census Tract 20, Saginaw County, Michigan",501,26,145,2000,292,209,41.71656686626746
"Census Tract 20, Calhoun County, Michigan",881,26,25,2000,555,326,37.003405221339385
"Census Tract 20, Berrien County, Michigan",793,26,21,2000,88,705,88.9029003783102
"Census Tract 20.02, Kalamazoo County, Michigan",814,26,77,2002,690,124,15.233415233415235
"Census Tract 20.03, Kalamazoo County, Michigan",673,26,77,2003,555,118,17.5334323922734
"Census Tract 20.04, Kalamazoo County, Michigan",321,26,77,2004,253,68,21.18380062305296
"Census Tract 20.05, Kalamazoo County, Michigan",510,26,77,2005,233,277,54.31372549019608
"Census Tract 21, Cass County, Michigan",982,26,27,2100,619,363,36.96537678207739
"Census Tract 21, Berrien County, Michigan",463,26,21,2100,169,294,63.498920086393085
"Census Tract 21, Muskegon County, Michigan",879,26,121,2100,599,280,31.85437997724687
"Census Tract 21, Calhoun County, Michigan",123,26,25,2100,107,16,13.008130081300814
"Census Tract 21, Marquette County, Michigan",154,26,103,2100,154,0,0.0
"Census Tract 21, Kent County, Michigan",1648,26,81,2100,1374,274,16.62621359223301
"Census Tract 21, Saginaw County, Michigan",426,26,145,2100,278,148,34.74178403755869
"Census Tract 21.01, Kalamazoo County, Michigan",373,26,77,2101,360,13,3.485254691689008
"Census Tract 21.01, Ingham County, Michigan",332,26,65,2101,173,159,47.89156626506024
"Census Tract 21.02, Kalamazoo County, Michigan",150,26,77,2102,111,39,26.0
"Census Tract 22, Berrien County, Michigan",789,26,21,2200,41,748,94.80354879594424
"Census Tract 22, Ingham County, Michigan",141,26,65,2200,69,72,51.06382978723404
"Census Tract 22, Genesee County, Michigan",283,26,49,2200,197,86,30.3886925795053
"Census Tract 22, Calhoun County, Michigan",165,26,25,2200,165,0,0.0
"Census Tract 22, Marquette County, Michigan",138,26,103,2200,98,40,28.985507246376812
"Census Tract 22, Kent County, Michigan",1194,26,81,2200,854,340,28.475711892797317
"Census Tract 22, Muskegon County, Michigan",720,26,121,2200,406,314,43.611111111111114
"Census Tract 22, Cass County, Michigan",610,26,27,2200,477,133,21.803278688524593
"Census Tract 22.01, Kalamazoo County, Michigan",208,26,77,2201,192,16,7.6923076923076925
"Census Tract 22.02, Kalamazoo County, Michigan",1582,26,77,2202,1021,561,35.46144121365361
"Census Tract 23, Calhoun County, Michigan",274,26,25,2300,193,81,29.56204379562044
"Census Tract 23, Muskegon County, Michigan",133,26,121,2300,120,13,9.774436090225564
"Census Tract 23, Genesee County, Michigan",282,26,49,2300,154,128,45.39007092198582
"Census Tract 23, Kent County, Michigan",395,26,81,2300,316,79,20.0
"Census Tract 23, Ingham County, Michigan",392,26,65,2300,250,142,36.224489795918366
"Census Tract 23, Marquette County, Michigan",103,26,103,2300,98,5,4.854368932038835
"Census Tract 23, Berrien County, Michigan",337,26,21,2300,92,245,72.70029673590504
"Census Tract 24, Kent County, Michigan",331,26,81,2400,285,46,13.897280966767372
"Census Tract 24, Marquette County, Michigan",836,26,103,2400,699,137,16.38755980861244
"Census Tract 24, Muskegon County, Michigan",557,26,121,2400,454,103,18.491921005385997
"Census Tract 24, Genesee County, Michigan",632,26,49,2400,283,349,55.22151898734177
"Census Tract 24, Calhoun County, Michigan",129,26,25,2400,85,44,34.10852713178294
"Census Tract 24, Berrien County, Michigan",68,26,21,2400,65,3,4.411764705882353
"Census Tract 25, Muskegon County, Michigan",192,26,121,2500,168,24,12.5
"Census Tract 25, Marquette County, Michigan",103,26,103,2500,95,8,7.766990291262135
"Census Tract 25, Calhoun County, Michigan",111,26,25,2500,111,0,0.0
"Census Tract 25, Berrien County, Michigan",298,26,21,2500,92,206,69.12751677852349
"Census Tract 25, Kent County, Michigan",1357,26,81,2500,1104,253,18.64406779661017
"Census Tract 26, Marquette County, Michigan",49,26,103,2600,48,1,2.0408163265306123
"Census Tract 26, Genesee County, Michigan",460,26,49,2600,318,142,30.869565217391305
"Census Tract 26, Ingham County, Michigan",313,26,65,2600,168,145,46.325878594249204
"Census Tract 26, Calhoun County, Michigan",868,26,25,2600,481,387,44.585253456221196
"Census Tract 26, Kent County, Michigan",628,26,81,2600,109,519,82.64331210191082
"Census Tract 26.01, Muskegon County, Michigan",430,26,121,2601,323,107,24.88372093023256
"Census Tract 26.01, Kalamazoo County, Michigan",316,26,77,2601,287,29,9.177215189873419
"Census Tract 26.02, Muskegon County, Michigan",563,26,121,2602,367,196,34.81349911190053
"Census Tract 27, Genesee County, Michigan",530,26,49,2700,306,224,42.26415094339623
"Census Tract 27, Muskegon County, Michigan",160,26,121,2700,160,0,0.0
"Census Tract 27, Kalamazoo County, Michigan",559,26,77,2700,488,71,12.701252236135957
"Census Tract 27, Ingham County, Michigan",311,26,65,2700,189,122,39.228295819935695
"Census Tract 27, Kent County, Michigan",714,26,81,2700,510,204,28.57142857142857
"Census Tract 27, Calhoun County, Michigan",188,26,25,2700,185,3,1.5957446808510638
"Census Tract 28, Marquette County, Michigan",628,26,103,2800,593,35,5.573248407643312
"Census Tract 28, Ingham County, Michigan",406,26,65,2800,170,236,58.128078817733986
"Census Tract 28, Muskegon County, Michigan",283,26,121,2800,257,26,9.187279151943462
"Census Tract 28, Calhoun County, Michigan",212,26,25,2800,176,36,16.9811320754717
"Census Tract 28, Kent County, Michigan",637,26,81,2800,159,478,75.0392464678179
"Census Tract 28, Genesee County, Michigan",494,26,49,2800,340,154,31.17408906882591
"Census Tract 28.01, Kalamazoo County, Michigan",252,26,77,2801,199,53,21.03174603174603
"Census Tract 28.02, Kalamazoo County, Michigan",766,26,77,2802,576,190,24.804177545691903
"Census Tract 29, Marquette County, Michigan",516,26,103,2900,511,5,0.9689922480620154
"Census Tract 29, Calhoun County, Michigan",194,26,25,2900,179,15,7.731958762886598
"Census Tract 29, Genesee County, Michigan",993,26,49,2900,330,663,66.76737160120845
"Census Tract 29, Muskegon County, Michigan",215,26,121,2900,175,40,18.6046511627907
"Census Tract 29, Kent County, Michigan",284,26,81,2900,209,75,26.408450704225352
"Census Tract 29.01, Ingham County, Michigan",630,26,65,2901,361,269,42.698412698412696
"Census Tract 29.01, Kalamazoo County, Michigan",47,26,77,2901,47,0,0.0
"Census Tract 29.02, Ingham County, Michigan",1897,26,65,2902,931,966,50.92250922509225
"Census Tract 29.03, Kalamazoo County, Michigan",2569,26,77,2903,1497,1072,41.728298949007396
"Census Tract 29.04, Kalamazoo County, Michigan",748,26,77,2904,479,269,35.962566844919785
"Census Tract 29.05, Kalamazoo County, Michigan",1614,26,77,2905,1219,395,24.473358116480792
"Census Tract 30, Kent County, Michigan",403,26,81,3000,228,175,43.424317617866
"Census Tract 30, Calhoun County, Michigan",113,26,25,3000,113,0,0.0
"Census Tract 30, Genesee County, Michigan",335,26,49,3000,111,224,66.86567164179105
"Census Tract 30, Muskegon County, Michigan",134,26,121,3000,126,8,5.970149253731343
"Census Tract 30.02, Kalamazoo County, Michigan",35,26,77,3002,35,0,0.0
"Census Tract 30.03, Kalamazoo County, Michigan",246,26,77,3003,203,43,17.479674796747968
"Census Tract 30.04, Kalamazoo County, Michigan",140,26,77,3004,119,21,15.0
"Census Tract 31, Genesee County, Michigan",457,26,49,3100,17,440,96.2800875273523
"Census Tract 31, Calhoun County, Michigan",305,26,25,3100,287,18,5.901639344262295
"Census Tract 31, Muskegon County, Michigan",306,26,121,3100,270,36,11.76470588235294
"Census Tract 31, Kent County, Michigan",659,26,81,3100,134,525,79.66616084977238
"Census Tract 31.03, Ingham County, Michigan",1130,26,65,3103,743,387,34.24778761061947
"Census Tract 32, Calhoun County, Michigan",97,26,25,3200,97,0,0.0
"Census Tract 32, Ingham County, Michigan",268,26,65,3200,107,161,60.07462686567165
"Census Tract 32, Kent County, Michigan",796,26,81,3200,189,607,76.25628140703517
"Census Tract 32, Muskegon County, Michigan",298,26,121,3200,298,0,0.0
"Census Tract 32, Genesee County, Michigan",412,26,49,3200,6,406,98.54368932038835
"Census Tract 33, Genesee County, Michigan",458,26,49,3300,151,307,67.03056768558952
"Census Tract 33, Muskegon County, Michigan",376,26,121,3300,314,62,16.48936170212766
"Census Tract 33, Kent County, Michigan",460,26,81,3300,346,114,24.782608695652176
"Census Tract 33, Calhoun County, Michigan",304,26,25,3300,146,158,51.973684210526315
"Census Tract 33.01, Ingham County, Michigan",494,26,65,3301,204,290,58.70445344129555
"Census Tract 33.02, Kalamazoo County, Michigan",281,26,77,3302,266,15,5.338078291814947
"Census Tract 33.02, Ingham County, Michigan",58,26,65,3302,39,19,32.758620689655174
"Census Tract 34, Ingham County, Michigan",334,26,65,3400,148,186,55.688622754491014
"Census Tract 34, Genesee County, Michigan",688,26,49,3400,89,599,87.06395348837209
"Census Tract 34, Muskegon County, Michigan",48,26,121,3400,48,0,0.0
"Census Tract 34, Calhoun County, Michigan",224,26,25,3400,136,88,39.285714285714285
"Census Tract 34, Kent County, Michigan",529,26,81,3400,351,178,33.64839319470699
"Census Tract 34, Kalamazoo County, Michigan",175,26,77,3400,149,26,14.857142857142858
"Census Tract 35, Ingham County, Michigan",586,26,65,3500,285,301,51.365187713310576
"Census Tract 35, Kent County, Michigan",891,26,81,3500,262,629,70.59483726150393
"Census Tract 35, Muskegon County, Michigan",244,26,121,3500,226,18,7.377049180327869
"Census Tract 35, Genesee County, Michigan",503,26,49,3500,289,214,42.54473161033797
"Census Tract 35, Kalamazoo County, Michigan",335,26,77,3500,308,27,8.059701492537313
"Census Tract 35, Calhoun County, Michigan",273,26,25,3500,187,86,31.5018315018315
"Census Tract 36, Muskegon County, Michigan",281,26,121,3600,224,57,20.284697508896798
"Census Tract 36, Calhoun County, Michigan",424,26,25,3600,144,280,66.0377358490566
"Census Tract 36, Genesee County, Michigan",1054,26,49,3600,610,444,42.125237191650854
"Census Tract 36, Kent County, Michigan",472,26,81,3600,64,408,86.4406779661017
"Census Tract 36.01, Ingham County, Michigan",229,26,65,3601,54,175,76.41921397379913
"Census Tract 36.02, Ingham County, Michigan",754,26,65,3602,124,630,83.55437665782493
"Census Tract 37, Calhoun County, Michigan",220,26,25,3700,197,23,10.454545454545453
"Census Tract 37, Kent County, Michigan",499,26,81,3700,76,423,84.76953907815631
"Census Tract 37, Muskegon County, Michigan",477,26,121,3700,424,53,11.11111111111111
"Census Tract 37, Genesee County, Michigan",469,26,49,3700,297,172,36.67377398720683
"Census Tract 37, Ingham County, Michigan",1099,26,65,3700,404,695,63.2393084622384
"Census Tract 38, Muskegon County, Michigan",372,26,121,3800,292,80,21.50537634408602
"Census Tract 38, Kent County, Michigan",689,26,81,3800,55,634,92.01741654571843
"Census Tract 38, Genesee County, Michigan",222,26,49,3800,130,92,41.44144144144144
"Census Tract 38, Calhoun County, Michigan",143,26,25,3800,143,0,0.0
"Census Tract 38.01, Ingham County, Michigan",907,26,65,3801,584,323,35.611907386990076
"Census Tract 38.02, Ingham County, Michigan",1580,26,65,3802,1043,537,33.98734177215189
"Census Tract 39, Kent County, Michigan",446,26,81,3900,17,429,96.18834080717488
"Census Tract 39, Muskegon County, Michigan",63,26,121,3900,35,28,44.44444444444444
"Census Tract 39, Calhoun County, Michigan",470,26,25,3900,428,42,8.936170212765958
"Census Tract 39.01, Ingham County, Michigan",347,26,65,3901,198,149,42.93948126801153
"Census Tract 39.02, Ingham County, Michigan",1070,26,65,3902,826,244,22.80373831775701
"Census Tract 40, Genesee County, Michigan",611,26,49,4000,400,211,34.53355155482815
"Census Tract 40, Calhoun County, Michigan",887,26,25,4000,809,78,8.793686583990981
"Census Tract 40, Kent County, Michigan",536,26,81,4000,69,467,87.1268656716418
"Census Tract 40, Muskegon County, Michigan",33,26,121,4000,33,0,0.0
"Census Tract 40, Ingham County, Michigan",975,26,65,4000,831,144,14.76923076923077
"Census Tract 41, Kent County, Michigan",366,26,81,4100,86,280,76.50273224043715
"Census Tract 41, Ingham County, Michigan",1206,26,65,4100,932,274,22.71973466003317
"Census Tract 41, Calhoun County, Michigan",629,26,25,4100,256,373,59.30047694753577
"Census Tract 42, Kent County, Michigan",351,26,81,4200,198,153,43.58974358974359
"Census Tract 42, Muskegon County, Michigan",1159,26,121,4200,581,578,49.87057808455565
"Census Tract 43, Kent County, Michigan",479,26,81,4300,256,223,46.5553235908142
"Census Tract 43, Muskegon County, Michigan",487,26,121,4300,28,459,94.25051334702259
"Census Tract 43.01, Ingham County, Michigan",923,26,65,4301,638,285,30.87757313109426
"Census Tract 43.02, Ingham County, Michigan",1040,26,65,4302,460,580,55.769230769230774
"Census Tract 44, Kent County, Michigan",1180,26,81,4400,840,340,28.8135593220339
"Census Tract 44.02, Ingham County, Michigan",671,26,65,4402,180,491,73.17436661698957
"Census Tract 44.03, Ingham County, Michigan",450,26,65,4403,201,249,55.333333333333336
"Census Tract 44.90, Ingham County, Michigan",0,26,65,4490,0,0,
"Census Tract 44.91, Ingham County, Michigan",0,26,65,4491,0,0,
"Census Tract 44.92, Ingham County, Michigan",0,26,65,4492,0,0,
"Census Tract 44.93, Ingham County, Michigan",0,26,65,4493,0,0,
"Census Tract 44.94, Ingham County, Michigan",0,26,65,4494,0,0,
"Census Tract 45, Kent County, Michigan",1225,26,81,4500,636,589,48.08163265306122
"Census Tract 45, Ingham County, Michigan",982,26,65,4500,497,485,49.38900203665988
"Census Tract 46, Ingham County, Michigan",250,26,65,4600,170,80,32.0
"Census Tract 46, Kent County, Michigan",1170,26,81,4600,228,942,80.51282051282051
"Census Tract 47, Ingham County, Michigan",585,26,65,4700,522,63,10.76923076923077
"Census Tract 48.01, Ingham County, Michigan",1291,26,65,4801,1120,171,13.245546088303643
"Census Tract 48.02, Ingham County, Michigan",252,26,65,4802,189,63,25.0
"Census Tract 49.01, Ingham County, Michigan",1323,26,65,4901,956,367,27.739984882842027
"Census Tract 49.02, Ingham County, Michigan",1219,26,65,4902,748,471,38.63822805578343
"Census Tract 50, Jackson County, Michigan",205,26,75,5000,199,6,2.9268292682926833
"Census Tract 50.01, Ingham County, Michigan",906,26,65,5001,572,334,36.86534216335541
"Census Tract 50.02, Ingham County, Michigan",90,26,65,5002,90,0,0.0
"Census Tract 51, Ingham County, Michigan",558,26,65,5100,213,345,61.82795698924731
"Census Tract 51, Jackson County, Michigan",280,26,75,5100,251,29,10.357142857142858
"Census Tract 52, Jackson County, Michigan",292,26,75,5200,247,45,15.41095890410959
"Census Tract 52.01, Ingham County, Michigan",1517,26,65,5201,692,825,54.38365194462755
"Census Tract 52.02, Ingham County, Michigan",137,26,65,5202,57,80,58.3941605839416
"Census Tract 53.01, Jackson County, Michigan",708,26,75,5301,568,140,19.774011299435028
"Census Tract 53.02, Ingham County, Michigan",1270,26,65,5302,818,452,35.59055118110236
"Census Tract 53.02, Jackson County, Michigan",500,26,75,5302,465,35,7.000000000000001
"Census Tract 53.03, Ingham County, Michigan",899,26,65,5303,675,224,24.916573971078975
"Census Tract 53.04, Ingham County, Michigan",800,26,65,5304,348,452,56.49999999999999
"Census Tract 54, Jackson County, Michigan",516,26,75,5400,479,37,7.170542635658915
"Census Tract 54.01, Ingham County, Michigan",473,26,65,5401,385,88,18.6046511627907
"Census Tract 54.02, Ingham County, Michigan",1149,26,65,5402,935,214,18.624891209747606
"Census Tract 55, Jackson County, Michigan",1627,26,75,5500,1417,210,12.907191149354642
"Census Tract 55.01, Ingham County, Michigan",248,26,65,5501,213,35,14.112903225806454
"Census Tract 55.01, Kalamazoo County, Michigan",502,26,77,5501,304,198,39.44223107569721
"Census Tract 55.02, Ingham County, Michigan",678,26,65,5502,540,138,20.353982300884958
"Census Tract 55.02, Kalamazoo County, Michigan",773,26,77,5502,396,377,48.77102199223803
"Census Tract 56, Ingham County, Michigan",127,26,65,5600,95,32,25.196850393700785
"Census Tract 56, Jackson County, Michigan",1432,26,75,5600,1225,207,14.455307262569834
"Census Tract 57, Jackson County, Michigan",417,26,75,5700,367,50,11.990407673860911
"Census Tract 57, Ingham County, Michigan",173,26,65,5700,173,0,0.0
"Census Tract 58, Jackson County, Michigan",0,26,75,5800,0,0,
"Census Tract 58, Ingham County, Michigan",627,26,65,5800,597,30,4.784688995215311
"Census Tract 59, Jackson County, Michigan",513,26,75,5900,451,62,12.085769980506821
"Census Tract 59, Ingham County, Michigan",241,26,65,5900,212,29,12.033195020746888
"Census Tract 60, Jackson County, Michigan",618,26,75,6000,575,43,6.957928802588997
"Census Tract 60.01, Ingham County, Michigan",125,26,65,6001,117,8,6.4
"Census Tract 60.02, Ingham County, Michigan",307,26,65,6002,282,25,8.143322475570033
"Census Tract 61, Ingham County, Michigan",225,26,65,6100,219,6,2.666666666666667
"Census Tract 61, Jackson County, Michigan",338,26,75,6100,338,0,0.0
"Census Tract 61.02, Kalamazoo County, Michigan",300,26,77,6102,265,35,11.666666666666666
"Census Tract 61.03, Kalamazoo County, Michigan",297,26,77,6103,275,22,7.4074074074074066
"Census Tract 62, Jackson County, Michigan",619,26,75,6200,560,59,9.531502423263328
"Census Tract 62, Ingham County, Michigan",251,26,65,6200,215,36,14.342629482071715
"Census Tract 63.01, Ingham County, Michigan",524,26,65,6301,416,108,20.610687022900763
"Census Tract 63.01, Jackson County, Michigan",48,26,75,6301,48,0,0.0
"Census Tract 63.02, Ingham County, Michigan",639,26,65,6302,596,43,6.729264475743349
"Census Tract 63.03, Jackson County, Michigan",357,26,75,6303,348,9,2.5210084033613445
"Census Tract 63.04, Jackson County, Michigan",114,26,75,6304,113,1,0.8771929824561403
"Census Tract 64.01, Ingham County, Michigan",79,26,65,6401,68,11,13.924050632911392
"Census Tract 64.01, Jackson County, Michigan",147,26,75,6401,147,0,0.0
"Census Tract 64.02, Jackson County, Michigan",426,26,75,6402,408,18,4.225352112676056
"Census Tract 64.02, Ingham County, Michigan",103,26,65,6402,95,8,7.766990291262135
"Census Tract 65, Jackson County, Michigan",239,26,75,6500,219,20,8.368200836820083
"Census Tract 65, Ingham County, Michigan",837,26,65,6500,564,273,32.61648745519714
"Census Tract 66, Jackson County, Michigan",328,26,75,6600,308,20,6.097560975609756
"Census Tract 66, Ingham County, Michigan",1133,26,65,6600,760,373,32.92144748455428
"Census Tract 66.01, Kalamazoo County, Michigan",150,26,77,6601,132,18,12.0
"Census Tract 67, Ingham County, Michigan",1450,26,65,6700,681,769,53.03448275862069
"Census Tract 67.01, Jackson County, Michigan",231,26,75,6701,182,49,21.21212121212121
"Census Tract 67.01, Kalamazoo County, Michigan",182,26,77,6701,176,6,3.296703296703297
"Census Tract 67.02, Jackson County, Michigan",152,26,75,6702,152,0,0.0
"Census Tract 67.02, Kalamazoo County, Michigan",393,26,77,6702,268,125,31.806615776081426
"Census Tract 68, Ingham County, Michigan",705,26,65,6800,256,449,63.68794326241135
"Census Tract 68.01, Jackson County, Michigan",107,26,75,6801,86,21,19.626168224299064
"Census Tract 68.03, Jackson County, Michigan",91,26,75,6803,69,22,24.175824175824175
"Census Tract 68.04, Jackson County, Michigan",182,26,75,6804,173,9,4.945054945054945
"Census Tract 69, Jackson County, Michigan",592,26,75,6900,397,195,32.939189189189186
"Census Tract 70, Ingham County, Michigan",711,26,65,7000,326,385,54.14908579465541
"Census Tract 101, Barry County, Michigan",545,26,15,10100,513,32,5.871559633027523
"Census Tract 101, Berrien County, Michigan",358,26,21,10100,340,18,5.027932960893855
"Census Tract 101, Van Buren County, Michigan",555,26,159,10100,514,41,7.3873873873873865
"Census Tract 101, Saginaw County, Michigan",623,26,145,10100,558,65,10.43338683788122
"Census Tract 101.01, Kent County, Michigan",203,26,81,10101,201,2,0.9852216748768473
"Census Tract 101.02, Kent County, Michigan",120,26,81,10102,120,0,0.0
"Census Tract 101.04, Clinton County, Michigan",245,26,37,10104,140,105,42.857142857142854
"Census Tract 101.05, Clinton County, Michigan",375,26,37,10105,351,24,6.4
"Census Tract 101.07, Clinton County, Michigan",369,26,37,10107,276,93,25.203252032520325
"Census Tract 101.08, Clinton County, Michigan",262,26,37,10108,258,4,1.5267175572519083
"Census Tract 101.10, Genesee County, Michigan",664,26,49,10110,574,90,13.55421686746988
"Census Tract 101.11, Genesee County, Michigan",45,26,49,10111,45,0,0.0
"Census Tract 101.12, Genesee County, Michigan",222,26,49,10112,213,9,4.054054054054054
"Census Tract 101.13, Genesee County, Michigan",583,26,49,10113,479,104,17.83876500857633
"Census Tract 101.14, Genesee County, Michigan",107,26,49,10114,107,0,0.0
"Census Tract 101.15, Genesee County, Michigan",138,26,49,10115,114,24,17.391304347826086
"Census Tract 102, Berrien County, Michigan",774,26,21,10200,707,67,8.656330749354005
"Census Tract 102, Kent County, Michigan",635,26,81,10200,537,98,15.433070866141732
"Census Tract 102, Saginaw County, Michigan",250,26,145,10200,227,23,9.2
"Census Tract 102, Van Buren County, Michigan",419,26,159,10200,318,101,24.105011933174225
"Census Tract 102, Barry County, Michigan",176,26,15,10200,157,19,10.795454545454545
"Census Tract 102.01, Clinton County, Michigan",197,26,37,10201,176,21,10.65989847715736
"Census Tract 102.01, Genesee County, Michigan",28,26,49,10201,28,0,0.0
"Census Tract 102.02, Genesee County, Michigan",35,26,49,10202,35,0,0.0
"Census Tract 102.03, Clinton County, Michigan",233,26,37,10203,188,45,19.313304721030043
"Census Tract 102.04, Clinton County, Michigan",36,26,37,10204,36,0,0.0
"Census Tract 103, Oceana County, Michigan",512,26,127,10300,359,153,29.8828125
"Census Tract 103, Clinton County, Michigan",179,26,37,10300,170,9,5.027932960893855
"Census Tract 103, Barry County, Michigan",578,26,15,10300,529,49,8.477508650519031
"Census Tract 103, Van Buren County, Michigan",480,26,159,10300,425,55,11.458333333333332
"Census Tract 103, Berrien County, Michigan",454,26,21,10300,443,11,2.4229074889867843
"Census Tract 103.01, Kent County, Michigan",297,26,81,10301,229,68,22.895622895622896
"Census Tract 103.02, Saginaw County, Michigan",843,26,145,10302,426,417,49.46619217081851
"Census Tract 103.02, Kent County, Michigan",36,26,81,10302,21,15,41.66666666666667
"Census Tract 103.03, Saginaw County, Michigan",294,26,145,10303,208,86,29.25170068027211
"Census Tract 103.04, Genesee County, Michigan",495,26,49,10304,161,334,67.47474747474747
"Census Tract 103.04, Saginaw County, Michigan",1178,26,145,10304,604,574,48.72665534804754
"Census Tract 103.05, Genesee County, Michigan",926,26,49,10305,234,692,74.73002159827213
"Census Tract 104, Clinton County, Michigan",107,26,37,10400,95,12,11.214953271028037
"Census Tract 104, Oceana County, Michigan",436,26,127,10400,325,111,25.458715596330272
"Census Tract 104, Berrien County, Michigan",145,26,21,10400,121,24,16.551724137931036
"Census Tract 104, Van Buren County, Michigan",351,26,159,10400,174,177,50.427350427350426
"Census Tract 104.01, Saginaw County, Michigan",573,26,145,10401,490,83,14.485165794066319
"Census Tract 104.01, Barry County, Michigan",255,26,15,10401,184,71,27.84313725490196
"Census Tract 104.01, Kent County, Michigan",182,26,81,10401,88,94,51.64835164835166
"Census Tract 104.02, Kent County, Michigan",606,26,81,10402,575,31,5.115511551155116
"Census Tract 104.02, Barry County, Michigan",248,26,15,10402,189,59,23.790322580645164
"Census Tract 104.02, Saginaw County, Michigan",512,26,145,10402,241,271,52.9296875
"Census Tract 104.03, Saginaw County, Michigan",1050,26,145,10403,884,166,15.80952380952381
"Census Tract 105, Oceana County, Michigan",180,26,127,10500,134,46,25.555555555555554
"Census Tract 105, Barry County, Michigan",148,26,15,10500,140,8,5.405405405405405
"Census Tract 105, Van Buren County, Michigan",407,26,159,10500,259,148,36.36363636363637
"Census Tract 105, Berrien County, Michigan",110,26,21,10500,95,15,13.636363636363635
"Census Tract 105, Clinton County, Michigan",174,26,37,10500,107,67,38.50574712643678
"Census Tract 105.01, Saginaw County, Michigan",79,26,145,10501,70,9,11.39240506329114
"Census Tract 105.01, Genesee County, Michigan",334,26,49,10501,248,86,25.748502994011975
"Census Tract 105.02, Saginaw County, Michigan",1127,26,145,10502,777,350,31.05590062111801
"Census Tract 105.02, Genesee County, Michigan",604,26,49,10502,195,409,67.71523178807946
"Census Tract 105.03, Genesee County, Michigan",84,26,49,10503,76,8,9.523809523809524
"Census Tract 105.04, Genesee County, Michigan",301,26,49,10504,184,117,38.87043189368771
"Census Tract 106, Van Buren County, Michigan",462,26,159,10600,169,293,63.41991341991342
"Census Tract 106, Saginaw County, Michigan",542,26,145,10600,314,228,42.066420664206646
"Census Tract 106, Clinton County, Michigan",106,26,37,10600,106,0,0.0
"Census Tract 106, Barry County, Michigan",439,26,15,10600,439,0,0.0
"Census Tract 106, Oceana County, Michigan",259,26,127,10600,231,28,10.81081081081081
"Census Tract 106, Kent County, Michigan",286,26,81,10600,286,0,0.0
"Census Tract 106, Berrien County, Michigan",440,26,21,10600,297,143,32.5
"Census Tract 106.03, Genesee County, Michigan",606,26,49,10603,606,0,0.0
"Census Tract 106.04, Genesee County, Michigan",150,26,49,10604,117,33,22.0
"Census Tract 106.10, Genesee County, Michigan",176,26,49,10610,165,11,6.25
"Census Tract 107, Saginaw County, Michigan",705,26,145,10700,439,266,37.730496453900706
"Census Tract 107, Barry County, Michigan",253,26,15,10700,253,0,0.0
"Census Tract 107, Kent County, Michigan",557,26,81,10700,538,19,3.4111310592459607
"Census Tract 107, Genesee County, Michigan",149,26,49,10700,109,40,26.845637583892618
"Census Tract 107.01, Clinton County, Michigan",72,26,37,10701,65,7,9.722222222222223
"Census Tract 107.02, Clinton County, Michigan",233,26,37,10702,182,51,21.888412017167383
"Census Tract 108, Saginaw County, Michigan",232,26,145,10800,144,88,37.93103448275862
"Census Tract 108, Oceana County, Michigan",175,26,127,10800,168,7,4.0
"Census Tract 108, Barry County, Michigan",181,26,15,10800,174,7,3.867403314917127
"Census Tract 108.01, Clinton County, Michigan",446,26,37,10801,429,17,3.811659192825112
"Census Tract 108.01, Kent County, Michigan",234,26,81,10801,234,0,0.0
"Census Tract 108.02, Kent County, Michigan",165,26,81,10802,100,65,39.39393939393939
"Census Tract 108.02, Clinton County, Michigan",459,26,37,10802,454,5,1.0893246187363834
"Census Tract 108.10, Genesee County, Michigan",267,26,49,10810,103,164,61.42322097378277
"Census Tract 108.11, Genesee County, Michigan",562,26,49,10811,42,520,92.52669039145907
"Census Tract 108.12, Genesee County, Michigan",838,26,49,10812,290,548,65.39379474940334
"Census Tract 108.13, Genesee County, Michigan",638,26,49,10813,507,131,20.532915360501566
"Census Tract 109, Van Buren County, Michigan",252,26,159,10900,252,0,0.0
"Census Tract 109, Oceana County, Michigan",116,26,127,10900,83,33,28.448275862068968
"Census Tract 109.01, Clinton County, Michigan",251,26,37,10901,246,5,1.9920318725099602
"Census Tract 109.02, Clinton County, Michigan",81,26,37,10902,64,17,20.98765432098765
"Census Tract 109.02, Kent County, Michigan",69,26,81,10902,69,0,0.0
"Census Tract 109.03, Kent County, Michigan",124,26,81,10903,124,0,0.0
"Census Tract 109.04, Kent County, Michigan",90,26,81,10904,90,0,0.0
"Census Tract 109.10, Genesee County, Michigan",552,26,49,10910,439,113,20.47101449275362
"Census Tract 109.11, Genesee County, Michigan",1262,26,49,10911,270,992,78.6053882725832
"Census Tract 109.12, Genesee County, Michigan",365,26,49,10912,285,80,21.91780821917808
"Census Tract 110, Berrien County, Michigan",193,26,21,11000,188,5,2.5906735751295336
"Census Tract 110, Oceana County, Michigan",92,26,127,11000,72,20,21.73913043478261
"Census Tract 110, Saginaw County, Michigan",1332,26,145,11000,99,1233,92.56756756756756
"Census Tract 110.01, Kent County, Michigan",64,26,81,11001,64,0,0.0
"Census Tract 110.01, Clinton County, Michigan",251,26,37,11001,232,19,7.569721115537849
"Census Tract 110.02, Kent County, Michigan",48,26,81,11002,26,22,45.83333333333333
"Census Tract 110.02, Clinton County, Michigan",50,26,37,11002,50,0,0.0
"Census Tract 110.02, Van Buren County, Michigan",558,26,159,11002,491,67,12.007168458781361
"Census Tract 110.10, Genesee County, Michigan",402,26,49,11010,304,98,24.378109452736318
"Census Tract 111, Saginaw County, Michigan",79,26,145,11100,60,19,24.050632911392405
"Census Tract 111, Berrien County, Michigan",635,26,21,11100,635,0,0.0
"Census Tract 111.01, Clinton County, Michigan",223,26,37,11101,223,0,0.0
"Census Tract 111.01, Genesee County, Michigan",765,26,49,11101,480,285,37.254901960784316
"Census Tract 111.01, Kent County, Michigan",214,26,81,11101,186,28,13.084112149532709
"Census Tract 111.02, Genesee County, Michigan",1480,26,49,11102,1185,295,19.93243243243243
"Census Tract 111.02, Kent County, Michigan",113,26,81,11102,63,50,44.24778761061947
"Census Tract 111.04, Clinton County, Michigan",902,26,37,11104,776,126,13.968957871396896
"Census Tract 112, Clinton County, Michigan",698,26,37,11200,418,280,40.114613180515754
"Census Tract 112, Saginaw County, Michigan",51,26,145,11200,47,4,7.8431372549019605
"Census Tract 112, Kent County, Michigan",565,26,81,11200,455,110,19.469026548672566
"Census Tract 112, Berrien County, Michigan",98,26,21,11200,90,8,8.16326530612245
"Census Tract 112.09, Genesee County, Michigan",1095,26,49,11209,730,365,33.33333333333333
"Census Tract 112.10, Genesee County, Michigan",432,26,49,11210,324,108,25.0
"Census Tract 112.11, Genesee County, Michigan",924,26,49,11211,530,394,42.64069264069264
"Census Tract 112.12, Genesee County, Michigan",708,26,49,11212,572,136,19.2090395480226
"Census Tract 112.13, Genesee County, Michigan",122,26,49,11213,112,10,8.19672131147541
"Census Tract 112.14, Genesee County, Michigan",580,26,49,11214,420,160,27.586206896551722
"Census Tract 113, Van Buren County, Michigan",375,26,159,11300,285,90,24.0
"Census Tract 113, Saginaw County, Michigan",773,26,145,11300,739,34,4.3984476067270375
"Census Tract 113, Berrien County, Michigan",345,26,21,11300,295,50,14.492753623188406
"Census Tract 113, Barry County, Michigan",732,26,15,11300,672,60,8.19672131147541
"Census Tract 113.01, Kent County, Michigan",152,26,81,11301,93,59,38.81578947368421
"Census Tract 113.01, Genesee County, Michigan",943,26,49,11301,520,423,44.85683987274655
"Census Tract 113.02, Kent County, Michigan",935,26,81,11302,811,124,13.262032085561499
"Census Tract 113.02, Genesee County, Michigan",406,26,49,11302,345,61,15.024630541871922
"Census Tract 114, Berrien County, Michigan",233,26,21,11400,222,11,4.721030042918455
"Census Tract 114, Barry County, Michigan",442,26,15,11400,389,53,11.990950226244344
"Census Tract 114, Van Buren County, Michigan",475,26,159,11400,344,131,27.57894736842105
"Census Tract 114.01, Kent County, Michigan",136,26,81,11401,75,61,44.85294117647059
"Census Tract 114.01, Genesee County, Michigan",519,26,49,11401,313,206,39.691714836223504
"Census Tract 114.02, Genesee County, Michigan",34,26,49,11402,34,0,0.0
"Census Tract 114.03, Kent County, Michigan",366,26,81,11403,312,54,14.754098360655737
"Census Tract 114.05, Kent County, Michigan",67,26,81,11405,45,22,32.83582089552239
"Census Tract 114.06, Kent County, Michigan",1840,26,81,11406,1135,705,38.315217391304344
"Census Tract 115, Van Buren County, Michigan",232,26,159,11500,134,98,42.241379310344826
"Census Tract 115, Kent County, Michigan",1708,26,81,11500,1380,328,19.20374707259953
"Census Tract 115, Saginaw County, Michigan",442,26,145,11500,193,249,56.334841628959275
"Census Tract 115, Berrien County, Michigan",135,26,21,11500,135,0,0.0
"Census Tract 115.02, Genesee County, Michigan",188,26,49,11502,152,36,19.148936170212767
"Census Tract 115.03, Genesee County, Michigan",278,26,49,11503,210,68,24.46043165467626
"Census Tract 115.05, Genesee County, Michigan",142,26,49,11505,134,8,5.633802816901409
"Census Tract 115.08, Genesee County, Michigan",460,26,49,11508,373,87,18.913043478260867
"Census Tract 116, Berrien County, Michigan",142,26,21,11600,117,25,17.6056338028169
"Census Tract 116, Kent County, Michigan",794,26,81,11600,663,131,16.49874055415617
"Census Tract 116, Van Buren County, Michigan",437,26,159,11600,320,117,26.773455377574372
"Census Tract 116, Saginaw County, Michigan",339,26,145,11600,132,207,61.06194690265486
"Census Tract 116.01, Genesee County, Michigan",85,26,49,11601,60,25,29.411764705882355
"Census Tract 116.10, Genesee County, Michigan",1105,26,49,11610,983,122,11.040723981900452
"Census Tract 117.01, Saginaw County, Michigan",12,26,145,11701,12,0,0.0
"Census Tract 117.01, Kent County, Michigan",531,26,81,11701,432,99,18.64406779661017
"Census Tract 117.02, Kent County, Michigan",787,26,81,11702,658,129,16.39135959339263
"Census Tract 117.02, Saginaw County, Michigan",88,26,145,11702,64,24,27.27272727272727
"Census Tract 117.10, Genesee County, Michigan",350,26,49,11710,350,0,0.0
"Census Tract 117.11, Genesee County, Michigan",725,26,49,11711,624,101,13.93103448275862
"Census Tract 117.12, Genesee County, Michigan",402,26,49,11712,370,32,7.960199004975125
"Census Tract 117.13, Genesee County, Michigan",1491,26,49,11713,1120,371,24.88262910798122
"Census Tract 117.14, Genesee County, Michigan",129,26,49,11714,106,23,17.829457364341085
"Census Tract 118, Van Buren County, Michigan",1077,26,159,11800,935,142,13.184772516248838
"Census Tract 118, Saginaw County, Michigan",144,26,145,11800,76,68,47.22222222222222
"Census Tract 118, Genesee County, Michigan",30,26,49,11800,30,0,0.0
"Census Tract 118.01, Kent County, Michigan",262,26,81,11801,262,0,0.0
"Census Tract 118.03, Kent County, Michigan",172,26,81,11803,147,25,14.534883720930234
"Census Tract 118.04, Kent County, Michigan",540,26,81,11804,515,25,4.62962962962963
"Census Tract 119, Van Buren County, Michigan",166,26,159,11900,136,30,18.072289156626507
"Census Tract 119.01, Kent County, Michigan",113,26,81,11901,74,39,34.51327433628318
"Census Tract 119.01, Saginaw County, Michigan",55,26,145,11901,46,9,16.363636363636363
"Census Tract 119.01, Genesee County, Michigan",145,26,49,11901,145,0,0.0
"Census Tract 119.02, Saginaw County, Michigan",50,26,145,11902,50,0,0.0
"Census Tract 119.02, Kent County, Michigan",182,26,81,11902,123,59,32.417582417582416
"Census Tract 119.02, Genesee County, Michigan",175,26,49,11902,175,0,0.0
"Census Tract 120, Van Buren County, Michigan",527,26,159,12000,376,151,28.6527514231499
"Census Tract 120.01, Saginaw County, Michigan",197,26,145,12001,180,17,8.629441624365482
"Census Tract 120.02, Saginaw County, Michigan",74,26,145,12002,74,0,0.0
"Census Tract 120.02, Kent County, Michigan",146,26,81,12002,114,32,21.91780821917808
"Census Tract 120.03, Kent County, Michigan",378,26,81,12003,378,0,0.0
"Census Tract 120.03, Genesee County, Michigan",391,26,49,12003,348,43,10.997442455242968
"Census Tract 120.03, Saginaw County, Michigan",360,26,145,12003,295,65,18.055555555555554
"Census Tract 120.04, Kent County, Michigan",678,26,81,12004,616,62,9.144542772861357
"Census Tract 120.06, Genesee County, Michigan",419,26,49,12006,337,82,19.570405727923628
"Census Tract 120.07, Genesee County, Michigan",105,26,49,12007,98,7,6.666666666666667
"Census Tract 120.08, Genesee County, Michigan",171,26,49,12008,153,18,10.526315789473683
"Census Tract 120.09, Genesee County, Michigan",67,26,49,12009,67,0,0.0
"Census Tract 121, Genesee County, Michigan",240,26,49,12100,188,52,21.666666666666668
"Census Tract 121, Saginaw County, Michigan",144,26,145,12100,144,0,0.0
"Census Tract 122, Saginaw County, Michigan",86,26,145,12200,81,5,5.813953488372093
"Census Tract 122.01, Kent County, Michigan",293,26,81,12201,267,26,8.873720136518772
"Census Tract 122.01, Genesee County, Michigan",345,26,49,12201,345,0,0.0
"Census Tract 122.02, Genesee County, Michigan",180,26,49,12202,61,119,66.11111111111111
"Census Tract 122.02, Kent County, Michigan",70,26,81,12202,70,0,0.0
"Census Tract 122.03, Kent County, Michigan",462,26,81,12203,301,161,34.84848484848485
"Census Tract 123, Kent County, Michigan",94,26,81,12300,94,0,0.0
"Census Tract 123, Saginaw County, Michigan",34,26,145,12300,24,10,29.411764705882355
"Census Tract 123.10, Genesee County, Michigan",598,26,49,12310,353,245,40.96989966555184
"Census Tract 123.11, Genesee County, Michigan",193,26,49,12311,87,106,54.92227979274611
"Census Tract 124, Kent County, Michigan",95,26,81,12400,95,0,0.0
"Census Tract 124, Saginaw County, Michigan",58,26,145,12400,53,5,8.620689655172415
"Census Tract 124.01, Genesee County, Michigan",74,26,49,12401,74,0,0.0
"Census Tract 124.02, Genesee County, Michigan",94,26,49,12402,94,0,0.0
"Census Tract 125, Kent County, Michigan",66,26,81,12500,54,12,18.181818181818183
"Census Tract 125, Saginaw County, Michigan",224,26,145,12500,218,6,2.6785714285714284
"Census Tract 125.01, Genesee County, Michigan",86,26,49,12501,50,36,41.86046511627907
"Census Tract 125.03, Genesee County, Michigan",170,26,49,12503,72,98,57.647058823529406
"Census Tract 125.04, Genesee County, Michigan",17,26,49,12504,17,0,0.0
"Census Tract 126, Saginaw County, Michigan",327,26,145,12600,322,5,1.529051987767584
"Census Tract 126.01, Genesee County, Michigan",94,26,49,12601,71,23,24.46808510638298
"Census Tract 126.02, Genesee County, Michigan",238,26,49,12602,199,39,16.386554621848738
"Census Tract 126.03, Genesee County, Michigan",26,26,49,12603,26,0,0.0
"Census Tract 126.04, Kent County, Michigan",519,26,81,12604,285,234,45.08670520231214
"Census Tract 126.05, Kent County, Michigan",199,26,81,12605,116,83,41.70854271356784
"Census Tract 126.06, Kent County, Michigan",1996,26,81,12606,961,1035,51.853707414829664
"Census Tract 126.07, Kent County, Michigan",2119,26,81,12607,977,1142,53.893345917885796
"Census Tract 126.08, Kent County, Michigan",1459,26,81,12608,982,477,32.69362577107608
"Census Tract 127, Saginaw County, Michigan",425,26,145,12700,391,34,8.0
"Census Tract 127.01, Kent County, Michigan",1552,26,81,12701,728,824,53.09278350515464
"Census Tract 127.02, Kent County, Michigan",286,26,81,12702,118,168,58.74125874125874
"Census Tract 127.02, Genesee County, Michigan",822,26,49,12702,640,182,22.14111922141119
"Census Tract 127.03, Genesee County, Michigan",84,26,49,12703,76,8,9.523809523809524
"Census Tract 127.03, Kent County, Michigan",505,26,81,12703,203,302,59.8019801980198
"Census Tract 127.04, Genesee County, Michigan",235,26,49,12704,195,40,17.02127659574468
"Census Tract 128, Kent County, Michigan",185,26,81,12800,115,70,37.83783783783784
"Census Tract 128.01, Genesee County, Michigan",65,26,49,12801,65,0,0.0
"Census Tract 128.02, Genesee County, Michigan",24,26,49,12802,21,3,12.5
"Census Tract 129, Saginaw County, Michigan",186,26,145,12900,162,24,12.903225806451612
"Census Tract 129.01, Kent County, Michigan",546,26,81,12901,278,268,49.08424908424908
"Census Tract 129.02, Kent County, Michigan",563,26,81,12902,277,286,50.799289520426285
"Census Tract 129.04, Genesee County, Michigan",402,26,49,12904,304,98,24.378109452736318
"Census Tract 129.05, Genesee County, Michigan",425,26,49,12905,188,237,55.76470588235294
"Census Tract 129.06, Genesee County, Michigan",85,26,49,12906,85,0,0.0
"Census Tract 129.07, Genesee County, Michigan",50,26,49,12907,50,0,0.0
"Census Tract 130, Saginaw County, Michigan",101,26,145,13000,101,0,0.0
"Census Tract 130, Kent County, Michigan",422,26,81,13000,370,52,12.322274881516588
"Census Tract 130.01, Genesee County, Michigan",46,26,49,13001,46,0,0.0
"Census Tract 130.02, Genesee County, Michigan",127,26,49,13002,127,0,0.0
"Census Tract 131, Kent County, Michigan",610,26,81,13100,419,191,31.311475409836063
"Census Tract 131, Saginaw County, Michigan",480,26,145,13100,382,98,20.416666666666668
"Census Tract 131.10, Genesee County, Michigan",34,26,49,13110,11,23,67.64705882352942
"Census Tract 131.11, Genesee County, Michigan",88,26,49,13111,88,0,0.0
"Census Tract 131.12, Genesee County, Michigan",57,26,49,13112,48,9,15.789473684210526
"Census Tract 131.13, Genesee County, Michigan",198,26,49,13113,198,0,0.0
"Census Tract 132, Kent County, Michigan",406,26,81,13200,356,50,12.31527093596059
"Census Tract 132.02, Genesee County, Michigan",1047,26,49,13202,981,66,6.303724928366762
"Census Tract 132.04, Genesee County, Michigan",953,26,49,13204,899,54,5.6663168940188875
"Census Tract 133, Kent County, Michigan",401,26,81,13300,201,200,49.87531172069826
"Census Tract 133.01, Genesee County, Michigan",293,26,49,13301,293,0,0.0
"Census Tract 134, Kent County, Michigan",433,26,81,13400,333,100,23.094688221709006
"Census Tract 134.01, Genesee County, Michigan",77,26,49,13401,77,0,0.0
"Census Tract 134.02, Genesee County, Michigan",52,26,49,13402,52,0,0.0
"Census Tract 135, Kent County, Michigan",721,26,81,13500,237,484,67.12898751733704
"Census Tract 135, Genesee County, Michigan",1009,26,49,13500,611,398,39.44499504459861
"Census Tract 136, Genesee County, Michigan",642,26,49,13600,80,562,87.53894080996885
"Census Tract 136, Kent County, Michigan",258,26,81,13600,128,130,50.3875968992248
"Census Tract 137, Kent County, Michigan",780,26,81,13700,152,628,80.51282051282051
"Census Tract 138.01, Kent County, Michigan",261,26,81,13801,101,160,61.30268199233716
"Census Tract 138.02, Kent County, Michigan",1987,26,81,13802,830,1157,58.228485153497736
"Census Tract 139, Kent County, Michigan",1084,26,81,13900,856,228,21.033210332103323
"Census Tract 140, Kent County, Michigan",841,26,81,14000,498,343,40.78478002378122
"Census Tract 141, Kent County, Michigan",167,26,81,14100,112,55,32.93413173652694
"Census Tract 142, Kent County, Michigan",404,26,81,14200,233,171,42.32673267326732
"Census Tract 143, Kent County, Michigan",194,26,81,14300,107,87,44.84536082474227
"Census Tract 145.01, Kent County, Michigan",1040,26,81,14501,753,287,27.596153846153847
"Census Tract 145.02, Kent County, Michigan",970,26,81,14502,739,231,23.81443298969072
"Census Tract 146.01, Kent County, Michigan",512,26,81,14601,451,61,11.9140625
"Census Tract 146.02, Kent County, Michigan",416,26,81,14602,396,20,4.807692307692308
"Census Tract 147.01, Kent County, Michigan",523,26,81,14701,246,277,52.96367112810707
"Census Tract 147.03, Kent County, Michigan",769,26,81,14703,296,473,61.508452535760725
"Census Tract 147.04, Kent County, Michigan",290,26,81,14704,275,15,5.172413793103448
"Census Tract 148.03, Kent County, Michigan",34,26,81,14803,34,0,0.0
"Census Tract 148.04, Kent County, Michigan",1475,26,81,14804,929,546,37.016949152542374
"Census Tract 148.05, Kent County, Michigan",192,26,81,14805,182,10,5.208333333333334
"Census Tract 148.06, Kent County, Michigan",122,26,81,14806,122,0,0.0
"Census Tract 148.07, Kent County, Michigan",350,26,81,14807,333,17,4.857142857142857
"Census Tract 201, Ottawa County, Michigan",214,26,139,20100,187,27,12.616822429906541
"Census Tract 201, Berrien County, Michigan",40,26,21,20100,40,0,0.0
"Census Tract 201.01, Eaton County, Michigan",0,26,45,20101,0,0,
"Census Tract 201.02, Eaton County, Michigan",1366,26,45,20102,822,544,39.82430453879942
"Census Tract 201.03, Eaton County, Michigan",669,26,45,20103,342,327,48.87892376681614
"Census Tract 201.04, Eaton County, Michigan",513,26,45,20104,248,265,51.656920077972714
"Census Tract 202, Berrien County, Michigan",814,26,21,20200,671,143,17.56756756756757
"Census Tract 202, Ottawa County, Michigan",411,26,139,20200,411,0,0.0
"Census Tract 202.01, Eaton County, Michigan",278,26,45,20201,200,78,28.05755395683453
"Census Tract 202.02, Eaton County, Michigan",824,26,45,20202,131,693,84.10194174757282
"Census Tract 203, Berrien County, Michigan",107,26,21,20300,85,22,20.5607476635514
"Census Tract 203.02, Eaton County, Michigan",245,26,45,20302,234,11,4.489795918367347
"Census Tract 203.03, Eaton County, Michigan",739,26,45,20303,510,229,30.987821380243574
"Census Tract 203.04, Eaton County, Michigan",1634,26,45,20304,1194,440,26.92778457772338
"Census Tract 204, Berrien County, Michigan",165,26,21,20400,138,27,16.363636363636363
"Census Tract 204, Ottawa County, Michigan",177,26,139,20400,155,22,12.429378531073446
"Census Tract 204.02, Eaton County, Michigan",210,26,45,20402,210,0,0.0
"Census Tract 204.03, Eaton County, Michigan",401,26,45,20403,354,47,11.72069825436409
"Census Tract 204.04, Eaton County, Michigan",724,26,45,20404,676,48,6.629834254143646
"Census Tract 205, Berrien County, Michigan",956,26,21,20500,680,276,28.870292887029287
"Census Tract 205, Eaton County, Michigan",107,26,45,20500,107,0,0.0
"Census Tract 205.01, Ottawa County, Michigan",429,26,139,20501,383,46,10.722610722610723
"Census Tract 205.03, Ottawa County, Michigan",130,26,139,20503,130,0,0.0
"Census Tract 205.04, Ottawa County, Michigan",700,26,139,20504,691,9,1.2857142857142856
"Census Tract 206, Ottawa County, Michigan",149,26,139,20600,132,17,11.409395973154362
"Census Tract 206, Berrien County, Michigan",516,26,21,20600,442,74,14.34108527131783
"Census Tract 206.01, Eaton County, Michigan",359,26,45,20601,340,19,5.2924791086350975
"Census Tract 206.02, Eaton County, Michigan",101,26,45,20602,82,19,18.81188118811881
"Census Tract 207, Berrien County, Michigan",595,26,21,20700,570,25,4.201680672268908
"Census Tract 207, Eaton County, Michigan",237,26,45,20700,217,20,8.438818565400844
"Census Tract 208, Eaton County, Michigan",276,26,45,20800,254,22,7.971014492753622
"Census Tract 209, Ottawa County, Michigan",620,26,139,20900,586,34,5.483870967741936
"Census Tract 209, Berrien County, Michigan",455,26,21,20900,351,104,22.857142857142858
"Census Tract 209.01, Eaton County, Michigan",595,26,45,20901,504,91,15.294117647058824
"Census Tract 209.02, Eaton County, Michigan",495,26,45,20902,473,22,4.444444444444445
"Census Tract 210, Berrien County, Michigan",777,26,21,21000,566,211,27.155727155727156
"Census Tract 210, Ottawa County, Michigan",527,26,139,21000,517,10,1.8975332068311195
"Census Tract 210.01, Eaton County, Michigan",349,26,45,21001,311,38,10.888252148997136
"Census Tract 210.02, Eaton County, Michigan",120,26,45,21002,111,9,7.5
"Census Tract 211, Berrien County, Michigan",78,26,21,21100,57,21,26.923076923076923
"Census Tract 211, Eaton County, Michigan",356,26,45,21100,345,11,3.089887640449438
"Census Tract 211, Ottawa County, Michigan",322,26,139,21100,304,18,5.590062111801243
"Census Tract 212, Berrien County, Michigan",111,26,21,21200,104,7,6.306306306306306
"Census Tract 212.01, Ottawa County, Michigan",174,26,139,21201,156,18,10.344827586206897
"Census Tract 212.01, Eaton County, Michigan",27,26,45,21201,27,0,0.0
"Census Tract 212.02, Ottawa County, Michigan",1196,26,139,21202,1084,112,9.364548494983277
"Census Tract 212.02, Eaton County, Michigan",113,26,45,21202,113,0,0.0
"Census Tract 213, Berrien County, Michigan",675,26,21,21300,234,441,65.33333333333333
"Census Tract 213.01, Ottawa County, Michigan",101,26,139,21301,61,40,39.603960396039604
"Census Tract 213.01, Eaton County, Michigan",391,26,45,21301,382,9,2.3017902813299234
"Census Tract 213.02, Eaton County, Michigan",516,26,45,21302,486,30,5.813953488372093
"Census Tract 213.03, Ottawa County, Michigan",47,26,139,21303,39,8,17.02127659574468
"Census Tract 213.04, Ottawa County, Michigan",71,26,139,21304,58,13,18.30985915492958
"Census Tract 214, Ottawa County, Michigan",446,26,139,21400,446,0,0.0
"Census Tract 214, Berrien County, Michigan",588,26,21,21400,263,325,55.27210884353742
"Census Tract 214.01, Eaton County, Michigan",571,26,45,21401,396,175,30.64798598949212
"Census Tract 214.02, Eaton County, Michigan",116,26,45,21402,97,19,16.379310344827587
"Census Tract 215, Ottawa County, Michigan",935,26,139,21500,857,78,8.342245989304812
"Census Tract 216.03, Ottawa County, Michigan",159,26,139,21603,114,45,28.30188679245283
"Census Tract 216.04, Ottawa County, Michigan",92,26,139,21604,92,0,0.0
"Census Tract 216.05, Ottawa County, Michigan",17,26,139,21605,17,0,0.0
"Census Tract 216.06, Ottawa County, Michigan",972,26,139,21606,972,0,0.0
"Census Tract 217, Ottawa County, Michigan",198,26,139,21700,181,17,8.585858585858585
"Census Tract 218.01, Ottawa County, Michigan",245,26,139,21801,163,82,33.46938775510204
"Census Tract 218.02, Ottawa County, Michigan",205,26,139,21802,185,20,9.75609756097561
"Census Tract 219.01, Ottawa County, Michigan",139,26,139,21901,112,27,19.424460431654676
"Census Tract 219.02, Ottawa County, Michigan",135,26,139,21902,135,0,0.0
"Census Tract 220.01, Ottawa County, Michigan",324,26,139,22001,214,110,33.95061728395062
"Census Tract 220.02, Ottawa County, Michigan",118,26,139,22002,92,26,22.033898305084744
"Census Tract 221.03, Ottawa County, Michigan",40,26,139,22103,40,0,0.0
"Census Tract 221.05, Ottawa County, Michigan",342,26,139,22105,237,105,30.701754385964914
"Census Tract 221.06, Ottawa County, Michigan",51,26,139,22106,40,11,21.568627450980394
"Census Tract 221.07, Ottawa County, Michigan",121,26,139,22107,102,19,15.702479338842975
"Census Tract 221.08, Ottawa County, Michigan",119,26,139,22108,75,44,36.97478991596639
"Census Tract 222.03, Ottawa County, Michigan",1599,26,139,22203,911,688,43.02689180737961
"Census Tract 222.06, Ottawa County, Michigan",141,26,139,22206,130,11,7.801418439716312
"Census Tract 226, Ottawa County, Michigan",92,26,139,22600,64,28,30.434782608695656
"Census Tract 229, Ottawa County, Michigan",659,26,139,22900,513,146,22.15477996965099
"Census Tract 230.01, Ottawa County, Michigan",291,26,139,23001,248,43,14.776632302405499
"Census Tract 230.02, Ottawa County, Michigan",255,26,139,23002,177,78,30.58823529411765
"Census Tract 231, Ottawa County, Michigan",1494,26,139,23100,873,621,41.566265060240966
"Census Tract 232, Ottawa County, Michigan",32,26,139,23200,32,0,0.0
"Census Tract 235, Ottawa County, Michigan",39,26,139,23500,39,0,0.0
"Census Tract 236, Ottawa County, Michigan",93,26,139,23600,93,0,0.0
"Census Tract 243, Ottawa County, Michigan",312,26,139,24300,283,29,9.294871794871796
"Census Tract 244, Ottawa County, Michigan",1237,26,139,24400,879,358,28.940986257073565
"Census Tract 245, Ottawa County, Michigan",1981,26,139,24500,1687,294,14.840989399293287
"Census Tract 246, Ottawa County, Michigan",270,26,139,24600,217,53,19.62962962962963
"Census Tract 249, Ottawa County, Michigan",1032,26,139,24900,725,307,29.748062015503873
"Census Tract 251, Ottawa County, Michigan",596,26,139,25100,426,170,28.523489932885905
"Census Tract 252, Ottawa County, Michigan",1054,26,139,25200,653,401,38.04554079696395
"Census Tract 255, Ottawa County, Michigan",227,26,139,25500,219,8,3.524229074889868
"Census Tract 257, Ottawa County, Michigan",785,26,139,25700,549,236,30.063694267515924
"Census Tract 258, Ottawa County, Michigan",771,26,139,25800,420,351,45.525291828793776
"Census Tract 301, Ionia County, Michigan",394,26,67,30100,350,44,11.16751269035533
"Census Tract 301, Shiawassee County, Michigan",305,26,155,30100,301,4,1.3114754098360655
"Census Tract 302, Allegan County, Michigan",113,26,5,30200,67,46,40.707964601769916
"Census Tract 302, Ionia County, Michigan",353,26,67,30200,295,58,16.43059490084986
"Census Tract 302, Shiawassee County, Michigan",158,26,155,30200,152,6,3.79746835443038
"Census Tract 303, Shiawassee County, Michigan",573,26,155,30300,573,0,0.0
"Census Tract 303, Ionia County, Michigan",569,26,67,30300,549,20,3.5149384885764503
"Census Tract 303, Allegan County, Michigan",169,26,5,30300,163,6,3.5502958579881656
"Census Tract 304, Shiawassee County, Michigan",426,26,155,30400,396,30,7.042253521126761
"Census Tract 304, Ionia County, Michigan",447,26,67,30400,339,108,24.161073825503358
"Census Tract 304.01, Allegan County, Michigan",157,26,5,30401,129,28,17.8343949044586
"Census Tract 304.02, Allegan County, Michigan",226,26,5,30402,226,0,0.0
"Census Tract 305, Allegan County, Michigan",811,26,5,30500,706,105,12.946979038224416
"Census Tract 305, Shiawassee County, Michigan",402,26,155,30500,323,79,19.65174129353234
"Census Tract 306, Shiawassee County, Michigan",550,26,155,30600,486,64,11.636363636363637
"Census Tract 306, Allegan County, Michigan",249,26,5,30600,185,64,25.702811244979916
"Census Tract 307, Shiawassee County, Michigan",463,26,155,30700,463,0,0.0
"Census Tract 307.02, Allegan County, Michigan",151,26,5,30702,122,29,19.205298013245034
"Census Tract 307.03, Allegan County, Michigan",225,26,5,30703,157,68,30.22222222222222
"Census Tract 307.04, Allegan County, Michigan",294,26,5,30704,233,61,20.74829931972789
"Census Tract 308, Allegan County, Michigan",449,26,5,30800,413,36,8.017817371937639
"Census Tract 308, Shiawassee County, Michigan",636,26,155,30800,611,25,3.930817610062893
"Census Tract 309.01, Allegan County, Michigan",162,26,5,30901,162,0,0.0
"Census Tract 309.02, Allegan County, Michigan",64,26,5,30902,49,15,23.4375
"Census Tract 310, Allegan County, Michigan",552,26,5,31000,371,181,32.789855072463766
"Census Tract 311, Allegan County, Michigan",357,26,5,31100,347,10,2.801120448179272
"Census Tract 312, Allegan County, Michigan",734,26,5,31200,509,225,30.65395095367847
"Census Tract 312, Ionia County, Michigan",380,26,67,31200,276,104,27.368421052631582
"Census Tract 313, Ionia County, Michigan",347,26,67,31300,340,7,2.0172910662824206
"Census Tract 313, Allegan County, Michigan",203,26,5,31300,203,0,0.0
"Census Tract 313.01, Shiawassee County, Michigan",117,26,155,31301,94,23,19.65811965811966
"Census Tract 313.02, Shiawassee County, Michigan",225,26,155,31302,196,29,12.88888888888889
"Census Tract 314, Ionia County, Michigan",233,26,67,31400,233,0,0.0
"Census Tract 314.01, Shiawassee County, Michigan",296,26,155,31401,293,3,1.0135135135135136
"Census Tract 314.02, Shiawassee County, Michigan",183,26,155,31402,183,0,0.0
"Census Tract 315, Shiawassee County, Michigan",578,26,155,31500,554,24,4.1522491349480966
"Census Tract 315, Ionia County, Michigan",613,26,67,31500,562,51,8.31973898858075
"Census Tract 316, Ionia County, Michigan",711,26,67,31600,600,111,15.611814345991561
"Census Tract 316, Shiawassee County, Michigan",608,26,155,31600,493,115,18.914473684210524
"Census Tract 317, Ionia County, Michigan",637,26,67,31700,532,105,16.483516483516482
"Census Tract 317, Shiawassee County, Michigan",391,26,155,31700,372,19,4.859335038363171
"Census Tract 318, Shiawassee County, Michigan",375,26,155,31800,346,29,7.733333333333333
"Census Tract 318, Allegan County, Michigan",428,26,5,31800,428,0,0.0
"Census Tract 319, Shiawassee County, Michigan",449,26,155,31900,415,34,7.57238307349666
"Census Tract 319, Allegan County, Michigan",437,26,5,31900,404,33,7.551487414187644
"Census Tract 319, Ionia County, Michigan",485,26,67,31900,359,126,25.979381443298973
"Census Tract 320, Allegan County, Michigan",348,26,5,32000,293,55,15.804597701149426
"Census Tract 321, Ionia County, Michigan",203,26,67,32100,186,17,8.374384236453201
"Census Tract 321, Allegan County, Michigan",210,26,5,32100,205,5,2.380952380952381
"Census Tract 322, Allegan County, Michigan",592,26,5,32200,500,92,15.54054054054054
"Census Tract 324.01, Allegan County, Michigan",286,26,5,32401,126,160,55.94405594405595
"Census Tract 324.02, Allegan County, Michigan",172,26,5,32402,162,10,5.813953488372093
"Census Tract 326, Allegan County, Michigan",178,26,5,32600,145,33,18.53932584269663
"Census Tract 401, St. Joseph County, Michigan",161,26,149,40100,122,39,24.22360248447205
"Census Tract 402, St. Joseph County, Michigan",292,26,149,40200,223,69,23.63013698630137
"Census Tract 403, St. Joseph County, Michigan",652,26,149,40300,434,218,33.43558282208589
"Census Tract 404, St. Joseph County, Michigan",373,26,149,40400,258,115,30.831099195710454
"Census Tract 405, St. Joseph County, Michigan",197,26,149,40500,149,48,24.36548223350254
"Census Tract 406, St. Joseph County, Michigan",646,26,149,40600,520,126,19.5046439628483
"Census Tract 407, St. Joseph County, Michigan",444,26,149,40700,368,76,17.117117117117118
"Census Tract 408, St. Joseph County, Michigan",565,26,149,40800,506,59,10.442477876106194
"Census Tract 409, St. Joseph County, Michigan",232,26,149,40900,229,3,1.293103448275862
"Census Tract 410, St. Joseph County, Michigan",175,26,149,41000,163,12,6.857142857142858
"Census Tract 411.01, St. Joseph County, Michigan",422,26,149,41101,373,49,11.61137440758294
"Census Tract 411.02, St. Joseph County, Michigan",167,26,149,41102,138,29,17.365269461077844
"Census Tract 412, St. Joseph County, Michigan",256,26,149,41200,233,23,8.984375
"Census Tract 413, St. Joseph County, Michigan",476,26,149,41300,466,10,2.100840336134454
"Census Tract 414, St. Joseph County, Michigan",550,26,149,41400,523,27,4.909090909090909
"Census Tract 415, St. Joseph County, Michigan",350,26,149,41500,326,24,6.857142857142858
"Census Tract 416, St. Joseph County, Michigan",174,26,149,41600,164,10,5.747126436781609
"Census Tract 501, Hillsdale County, Michigan",189,26,59,50100,189,0,0.0
"Census Tract 502, Hillsdale County, Michigan",211,26,59,50200,208,3,1.4218009478672986
"Census Tract 503, Hillsdale County, Michigan",296,26,59,50300,281,15,5.0675675675675675
"Census Tract 504, Hillsdale County, Michigan",301,26,59,50400,287,14,4.651162790697675
"Census Tract 505, Hillsdale County, Michigan",471,26,59,50500,430,41,8.70488322717622
"Census Tract 506, Hillsdale County, Michigan",349,26,59,50600,336,13,3.7249283667621778
"Census Tract 507, Hillsdale County, Michigan",1135,26,59,50700,1095,40,3.524229074889868
"Census Tract 508, Hillsdale County, Michigan",234,26,59,50800,225,9,3.8461538461538463
"Census Tract 509, Hillsdale County, Michigan",271,26,59,50900,256,15,5.535055350553505
"Census Tract 510, Hillsdale County, Michigan",283,26,59,51000,258,25,8.8339222614841
"Census Tract 511, Hillsdale County, Michigan",286,26,59,51100,270,16,5.594405594405594
"Census Tract 512, Hillsdale County, Michigan",234,26,59,51200,233,1,0.4273504273504274
"Census Tract 601, Lenawee County, Michigan",142,26,91,60100,136,6,4.225352112676056
"Census Tract 603.01, Lenawee County, Michigan",121,26,91,60301,88,33,27.27272727272727
"Census Tract 603.02, Lenawee County, Michigan",261,26,91,60302,252,9,3.4482758620689653
"Census Tract 604.01, Lenawee County, Michigan",205,26,91,60401,202,3,1.4634146341463417
"Census Tract 604.02, Lenawee County, Michigan",253,26,91,60402,253,0,0.0
"Census Tract 605, Lenawee County, Michigan",181,26,91,60500,159,22,12.154696132596685
"Census Tract 606, Lenawee County, Michigan",212,26,91,60600,189,23,10.849056603773585
"Census Tract 607, Lenawee County, Michigan",182,26,91,60700,162,20,10.989010989010989
"Census Tract 608, Lenawee County, Michigan",708,26,91,60800,625,83,11.72316384180791
"Census Tract 612, Lenawee County, Michigan",123,26,91,61200,123,0,0.0
"Census Tract 613.01, Lenawee County, Michigan",606,26,91,61301,466,140,23.1023102310231
"Census Tract 613.02, Lenawee County, Michigan",733,26,91,61302,527,206,28.10368349249659
"Census Tract 614, Lenawee County, Michigan",673,26,91,61400,465,208,30.906389301634473
"Census Tract 615, Lenawee County, Michigan",643,26,91,61500,384,259,40.27993779160187
"Census Tract 616, Lenawee County, Michigan",643,26,91,61600,451,192,29.86003110419907
"Census Tract 617, Lenawee County, Michigan",749,26,91,61700,711,38,5.07343124165554
"Census Tract 618, Lenawee County, Michigan",371,26,91,61800,322,49,13.20754716981132
"Census Tract 619, Lenawee County, Michigan",428,26,91,61900,389,39,9.11214953271028
"Census Tract 620, Lenawee County, Michigan",202,26,91,62000,186,16,7.920792079207921
"Census Tract 621, Lenawee County, Michigan",240,26,91,62100,228,12,5.0
"Census Tract 622, Lenawee County, Michigan",319,26,91,62200,314,5,1.5673981191222568
"Census Tract 623, Lenawee County, Michigan",251,26,91,62300,206,45,17.928286852589643
"Census Tract 624, Lenawee County, Michigan",371,26,91,62400,359,12,3.234501347708895
"Census Tract 1200, Oakland County, Michigan",89,26,125,120000,89,0,0.0
"Census Tract 1203, Oakland County, Michigan",109,26,125,120300,100,9,8.256880733944955
"Census Tract 1210, Oakland County, Michigan",205,26,125,121000,158,47,22.926829268292686
"Census Tract 1214, Oakland County, Michigan",203,26,125,121400,139,64,31.527093596059114
"Census Tract 1215, Oakland County, Michigan",571,26,125,121500,497,74,12.95971978984238
"Census Tract 1217, Oakland County, Michigan",220,26,125,121700,176,44,20.0
"Census Tract 1218, Oakland County, Michigan",125,26,125,121800,125,0,0.0
"Census Tract 1222, Oakland County, Michigan",38,26,125,122200,38,0,0.0
"Census Tract 1224, Oakland County, Michigan",146,26,125,122400,146,0,0.0
"Census Tract 1227, Oakland County, Michigan",74,26,125,122700,74,0,0.0
"Census Tract 1229, Oakland County, Michigan",176,26,125,122900,176,0,0.0
"Census Tract 1230, Oakland County, Michigan",183,26,125,123000,155,28,15.300546448087433
"Census Tract 1231, Oakland County, Michigan",29,26,125,123100,27,2,6.896551724137931
"Census Tract 1240, Oakland County, Michigan",177,26,125,124000,177,0,0.0
"Census Tract 1245, Oakland County, Michigan",851,26,125,124500,761,90,10.575793184488838
"Census Tract 1250, Oakland County, Michigan",55,26,125,125000,55,0,0.0
"Census Tract 1256, Oakland County, Michigan",55,26,125,125600,47,8,14.545454545454545
"Census Tract 1262, Oakland County, Michigan",16,26,125,126200,16,0,0.0
"Census Tract 1263, Oakland County, Michigan",351,26,125,126300,290,61,17.37891737891738
"Census Tract 1264, Oakland County, Michigan",72,26,125,126400,47,25,34.72222222222222
"Census Tract 1265, Oakland County, Michigan",95,26,125,126500,95,0,0.0
"Census Tract 1270, Oakland County, Michigan",93,26,125,127000,93,0,0.0
"Census Tract 1271, Oakland County, Michigan",18,26,125,127100,18,0,0.0
"Census Tract 1272, Oakland County, Michigan",114,26,125,127200,95,19,16.666666666666664
"Census Tract 1273, Oakland County, Michigan",824,26,125,127300,724,100,12.135922330097088
"Census Tract 1274, Oakland County, Michigan",90,26,125,127400,55,35,38.88888888888889
"Census Tract 1275, Oakland County, Michigan",540,26,125,127500,351,189,35.0
"Census Tract 1276, Oakland County, Michigan",45,26,125,127600,45,0,0.0
"Census Tract 1277, Oakland County, Michigan",836,26,125,127700,744,92,11.004784688995215
"Census Tract 1280, Oakland County, Michigan",150,26,125,128000,94,56,37.333333333333336
"Census Tract 1281, Oakland County, Michigan",96,26,125,128100,96,0,0.0
"Census Tract 1282, Oakland County, Michigan",47,26,125,128200,22,25,53.191489361702125
"Census Tract 1283, Oakland County, Michigan",593,26,125,128300,470,123,20.741989881956155
"Census Tract 1284, Oakland County, Michigan",575,26,125,128400,390,185,32.17391304347826
"Census Tract 1285, Oakland County, Michigan",327,26,125,128500,252,75,22.93577981651376
"Census Tract 1286, Oakland County, Michigan",60,26,125,128600,53,7,11.666666666666666
"Census Tract 1287, Oakland County, Michigan",51,26,125,128700,15,36,70.58823529411765
"Census Tract 1288, Oakland County, Michigan",26,26,125,128800,26,0,0.0
"Census Tract 1289, Oakland County, Michigan",704,26,125,128900,575,129,18.323863636363637
"Census Tract 1290, Oakland County, Michigan",380,26,125,129000,364,16,4.2105263157894735
"Census Tract 1300, Oakland County, Michigan",255,26,125,130000,180,75,29.411764705882355
"Census Tract 1301, Oakland County, Michigan",117,26,125,130100,100,17,14.529914529914532
"Census Tract 1302, Oakland County, Michigan",272,26,125,130200,272,0,0.0
"Census Tract 1303, Oakland County, Michigan",15,26,125,130300,15,0,0.0
"Census Tract 1304, Oakland County, Michigan",73,26,125,130400,58,15,20.54794520547945
"Census Tract 1305, Oakland County, Michigan",77,26,125,130500,77,0,0.0
"Census Tract 1306, Oakland County, Michigan",59,26,125,130600,54,5,8.47457627118644
"Census Tract 1307, Oakland County, Michigan",415,26,125,130700,400,15,3.614457831325301
"Census Tract 1311, Oakland County, Michigan",21,26,125,131100,21,0,0.0
"Census Tract 1313, Oakland County, Michigan",257,26,125,131300,257,0,0.0
"Census Tract 1314, Oakland County, Michigan",83,26,125,131400,83,0,0.0
"Census Tract 1315, Oakland County, Michigan",74,26,125,131500,74,0,0.0
"Census Tract 1316, Oakland County, Michigan",16,26,125,131600,16,0,0.0
"Census Tract 1318, Oakland County, Michigan",184,26,125,131800,184,0,0.0
"Census Tract 1321, Oakland County, Michigan",499,26,125,132100,424,75,15.030060120240481
"Census Tract 1325, Oakland County, Michigan",539,26,125,132500,539,0,0.0
"Census Tract 1326, Oakland County, Michigan",25,26,125,132600,25,0,0.0
"Census Tract 1327, Oakland County, Michigan",188,26,125,132700,155,33,17.5531914893617
"Census Tract 1330.01, Oakland County, Michigan",5,26,125,133001,5,0,0.0
"Census Tract 1330.02, Oakland County, Michigan",170,26,125,133002,156,14,8.235294117647058
"Census Tract 1330.03, Oakland County, Michigan",519,26,125,133003,374,145,27.9383429672447
"Census Tract 1331, Oakland County, Michigan",2522,26,125,133100,1249,1273,50.475812846946866
"Census Tract 1340, Oakland County, Michigan",177,26,125,134000,156,21,11.864406779661017
"Census Tract 1343, Oakland County, Michigan",229,26,125,134300,184,45,19.65065502183406
"Census Tract 1344, Oakland County, Michigan",214,26,125,134400,214,0,0.0
"Census Tract 1345, Oakland County, Michigan",255,26,125,134500,225,30,11.76470588235294
"Census Tract 1346, Oakland County, Michigan",338,26,125,134600,328,10,2.9585798816568047
"Census Tract 1347, Oakland County, Michigan",819,26,125,134700,583,236,28.815628815628813
"Census Tract 1348, Oakland County, Michigan",371,26,125,134800,162,209,56.334231805929925
"Census Tract 1349, Oakland County, Michigan",776,26,125,134900,563,213,27.448453608247426
"Census Tract 1350, Oakland County, Michigan",47,26,125,135000,47,0,0.0
"Census Tract 1351, Oakland County, Michigan",81,26,125,135100,81,0,0.0
"Census Tract 1352, Oakland County, Michigan",208,26,125,135200,113,95,45.67307692307692
"Census Tract 1353, Oakland County, Michigan",33,26,125,135300,33,0,0.0
"Census Tract 1360, Oakland County, Michigan",559,26,125,136000,263,296,52.95169946332737
"Census Tract 1361.01, Oakland County, Michigan",530,26,125,136101,265,265,50.0
"Census Tract 1361.02, Oakland County, Michigan",2202,26,125,136102,1332,870,39.509536784741144
"Census Tract 1363, Oakland County, Michigan",902,26,125,136300,378,524,58.09312638580931
"Census Tract 1365, Oakland County, Michigan",599,26,125,136500,135,464,77.46243739565944
"Census Tract 1366, Oakland County, Michigan",1009,26,125,136600,471,538,53.320118929633296
"Census Tract 1367, Oakland County, Michigan",563,26,125,136700,211,352,62.522202486678516
"Census Tract 1368, Oakland County, Michigan",662,26,125,136800,567,95,14.350453172205437
"Census Tract 1371, Oakland County, Michigan",597,26,125,137100,312,285,47.73869346733669
"Census Tract 1374, Oakland County, Michigan",15,26,125,137400,15,0,0.0
"Census Tract 1377, Oakland County, Michigan",178,26,125,137700,137,41,23.03370786516854
"Census Tract 1378, Oakland County, Michigan",198,26,125,137800,155,43,21.71717171717172
"Census Tract 1381, Oakland County, Michigan",190,26,125,138100,157,33,17.36842105263158
"Census Tract 1383.01, Oakland County, Michigan",298,26,125,138301,221,77,25.838926174496645
"Census Tract 1383.02, Oakland County, Michigan",469,26,125,138302,437,32,6.823027718550106
"Census Tract 1386, Oakland County, Michigan",38,26,125,138600,34,4,10.526315789473683
"Census Tract 1392, Oakland County, Michigan",634,26,125,139200,568,66,10.410094637223976
"Census Tract 1394, Oakland County, Michigan",410,26,125,139400,390,20,4.878048780487805
"Census Tract 1401, Oakland County, Michigan",132,26,125,140100,114,18,13.636363636363635
"Census Tract 1403.01, Oakland County, Michigan",1578,26,125,140301,631,947,60.01267427122941
"Census Tract 1403.02, Oakland County, Michigan",1008,26,125,140302,580,428,42.46031746031746
"Census Tract 1405, Oakland County, Michigan",571,26,125,140500,333,238,41.68126094570928
"Census Tract 1406, Oakland County, Michigan",252,26,125,140600,107,145,57.53968253968254
"Census Tract 1407, Oakland County, Michigan",597,26,125,140700,292,305,51.08877721943048
"Census Tract 1408, Oakland County, Michigan",1197,26,125,140800,442,755,63.074352548036764
"Census Tract 1409, Oakland County, Michigan",471,26,125,140900,176,295,62.63269639065817
"Census Tract 1410, Oakland County, Michigan",1571,26,125,141000,572,999,63.59007001909611
"Census Tract 1411, Oakland County, Michigan",638,26,125,141100,308,330,51.724137931034484
"Census Tract 1412, Oakland County, Michigan",1247,26,125,141200,311,936,75.06014434643143
"Census Tract 1413, Oakland County, Michigan",634,26,125,141300,277,357,56.30914826498423
"Census Tract 1414, Oakland County, Michigan",781,26,125,141400,156,625,80.02560819462228
"Census Tract 1415, Oakland County, Michigan",1372,26,125,141500,235,1137,82.87172011661808
"Census Tract 1416, Oakland County, Michigan",744,26,125,141600,67,677,90.99462365591397
"Census Tract 1417, Oakland County, Michigan",528,26,125,141700,122,406,76.89393939393939
"Census Tract 1420, Oakland County, Michigan",602,26,125,142000,196,406,67.44186046511628
"Census Tract 1421, Oakland County, Michigan",293,26,125,142100,94,199,67.91808873720136
"Census Tract 1422, Oakland County, Michigan",886,26,125,142200,106,780,88.03611738148985
"Census Tract 1423, Oakland County, Michigan",883,26,125,142300,114,769,87.08946772366932
"Census Tract 1424, Oakland County, Michigan",776,26,125,142400,45,731,94.20103092783505
"Census Tract 1425, Oakland County, Michigan",400,26,125,142500,64,336,84.0
"Census Tract 1426, Oakland County, Michigan",751,26,125,142600,385,366,48.73501997336884
"Census Tract 1427, Oakland County, Michigan",1090,26,125,142700,66,1024,93.94495412844037
"Census Tract 1435, Oakland County, Michigan",203,26,125,143500,131,72,35.467980295566505
"Census Tract 1441, Oakland County, Michigan",389,26,125,144100,279,110,28.277634961439592
"Census Tract 1442, Oakland County, Michigan",112,26,125,144200,90,22,19.642857142857142
"Census Tract 1443, Oakland County, Michigan",264,26,125,144300,200,64,24.242424242424242
"Census Tract 1444, Oakland County, Michigan",397,26,125,144400,349,48,12.090680100755668
"Census Tract 1445, Oakland County, Michigan",97,26,125,144500,85,12,12.371134020618557
"Census Tract 1446, Oakland County, Michigan",186,26,125,144600,186,0,0.0
"Census Tract 1447.01, Oakland County, Michigan",892,26,125,144701,574,318,35.65022421524663
"Census Tract 1448, Oakland County, Michigan",399,26,125,144800,299,100,25.062656641604008
"Census Tract 1449, Oakland County, Michigan",1122,26,125,144900,680,442,39.39393939393939
"Census Tract 1451, Oakland County, Michigan",99,26,125,145100,70,29,29.292929292929294
"Census Tract 1452, Oakland County, Michigan",719,26,125,145200,498,221,30.737134909596662
"Census Tract 1453, Oakland County, Michigan",491,26,125,145300,440,51,10.386965376782078
"Census Tract 1454, Oakland County, Michigan",486,26,125,145400,319,167,34.36213991769547
"Census Tract 1455.01, Oakland County, Michigan",349,26,125,145501,317,32,9.169054441260744
"Census Tract 1455.02, Oakland County, Michigan",657,26,125,145502,626,31,4.71841704718417
"Census Tract 1456, Oakland County, Michigan",406,26,125,145600,351,55,13.546798029556651
"Census Tract 1457, Oakland County, Michigan",357,26,125,145700,209,148,41.45658263305322
"Census Tract 1459, Oakland County, Michigan",907,26,125,145900,683,224,24.696802646085995
"Census Tract 1500, Oakland County, Michigan",212,26,125,150000,205,7,3.30188679245283
"Census Tract 1501, Oakland County, Michigan",449,26,125,150100,289,160,35.634743875278396
"Census Tract 1502, Oakland County, Michigan",32,26,125,150200,26,6,18.75
"Census Tract 1503, Oakland County, Michigan",146,26,125,150300,106,40,27.397260273972602
"Census Tract 1504, Oakland County, Michigan",31,26,125,150400,20,11,35.483870967741936
"Census Tract 1505, Oakland County, Michigan",16,26,125,150500,16,0,0.0
"Census Tract 1506, Oakland County, Michigan",55,26,125,150600,39,16,29.09090909090909
"Census Tract 1507, Oakland County, Michigan",55,26,125,150700,42,13,23.636363636363637
"Census Tract 1508, Oakland County, Michigan",149,26,125,150800,54,95,63.758389261744966
"Census Tract 1509, Oakland County, Michigan",496,26,125,150900,325,171,34.475806451612904
"Census Tract 1510, Oakland County, Michigan",41,26,125,151000,29,12,29.268292682926827
"Census Tract 1520, Oakland County, Michigan",109,26,125,152000,91,18,16.51376146788991
"Census Tract 1526, Oakland County, Michigan",196,26,125,152600,149,47,23.97959183673469
"Census Tract 1527, Oakland County, Michigan",81,26,125,152700,41,40,49.382716049382715
"Census Tract 1529, Oakland County, Michigan",786,26,125,152900,603,183,23.282442748091604
"Census Tract 1530, Oakland County, Michigan",441,26,125,153000,370,71,16.099773242630384
"Census Tract 1531, Oakland County, Michigan",136,26,125,153100,125,11,8.088235294117647
"Census Tract 1532, Oakland County, Michigan",398,26,125,153200,346,52,13.06532663316583
"Census Tract 1533, Oakland County, Michigan",325,26,125,153300,248,77,23.692307692307693
"Census Tract 1540, Oakland County, Michigan",194,26,125,154000,163,31,15.979381443298967
"Census Tract 1541, Oakland County, Michigan",207,26,125,154100,168,39,18.84057971014493
"Census Tract 1542, Oakland County, Michigan",517,26,125,154200,435,82,15.860735009671178
"Census Tract 1545, Oakland County, Michigan",46,26,125,154500,18,28,60.86956521739131
"Census Tract 1546, Oakland County, Michigan",55,26,125,154600,22,33,60.0
"Census Tract 1560, Oakland County, Michigan",204,26,125,156000,156,48,23.52941176470588
"Census Tract 1561, Oakland County, Michigan",55,26,125,156100,36,19,34.54545454545455
"Census Tract 1562, Oakland County, Michigan",226,26,125,156200,207,19,8.4070796460177
"Census Tract 1563, Oakland County, Michigan",115,26,125,156300,97,18,15.65217391304348
"Census Tract 1564, Oakland County, Michigan",136,26,125,156400,68,68,50.0
"Census Tract 1565, Oakland County, Michigan",80,26,125,156500,53,27,33.75
"Census Tract 1569, Oakland County, Michigan",18,26,125,156900,0,18,100.0
"Census Tract 1570, Oakland County, Michigan",56,26,125,157000,44,12,21.428571428571427
"Census Tract 1571, Oakland County, Michigan",47,26,125,157100,26,21,44.680851063829785
"Census Tract 1572, Oakland County, Michigan",540,26,125,157200,316,224,41.48148148148148
"Census Tract 1573, Oakland County, Michigan",278,26,125,157300,136,142,51.07913669064749
"Census Tract 1574, Oakland County, Michigan",52,26,125,157400,29,23,44.230769230769226
"Census Tract 1575, Oakland County, Michigan",1096,26,125,157500,802,294,26.824817518248175
"Census Tract 1576, Oakland County, Michigan",556,26,125,157600,290,266,47.84172661870504
"Census Tract 1577, Oakland County, Michigan",30,26,125,157700,30,0,0.0
"Census Tract 1578, Oakland County, Michigan",553,26,125,157800,267,286,51.71790235081374
"Census Tract 1579, Oakland County, Michigan",144,26,125,157900,40,104,72.22222222222221
"Census Tract 1580, Oakland County, Michigan",63,26,125,158000,63,0,0.0
"Census Tract 1581, Oakland County, Michigan",251,26,125,158100,81,170,67.72908366533864
"Census Tract 1582, Oakland County, Michigan",55,26,125,158200,55,0,0.0
"Census Tract 1590, Oakland County, Michigan",133,26,125,159000,111,22,16.541353383458645
"Census Tract 1600, Oakland County, Michigan",67,26,125,160000,0,67,100.0
"Census Tract 1603, Oakland County, Michigan",1913,26,125,160300,326,1587,82.95870360690016
"Census Tract 1604, Oakland County, Michigan",1195,26,125,160400,135,1060,88.70292887029288
"Census Tract 1605, Oakland County, Michigan",730,26,125,160500,272,458,62.73972602739726
"Census Tract 1606, Oakland County, Michigan",379,26,125,160600,127,252,66.49076517150397
"Census Tract 1607, Oakland County, Michigan",108,26,125,160700,20,88,81.48148148148148
"Census Tract 1608, Oakland County, Michigan",757,26,125,160800,141,616,81.37384412153237
"Census Tract 1609, Oakland County, Michigan",2042,26,125,160900,577,1465,71.74338883447601
"Census Tract 1610, Oakland County, Michigan",487,26,125,161000,49,438,89.93839835728953
"Census Tract 1611, Oakland County, Michigan",1687,26,125,161100,445,1242,73.62181387077653
"Census Tract 1612, Oakland County, Michigan",161,26,125,161200,31,130,80.74534161490683
"Census Tract 1613, Oakland County, Michigan",460,26,125,161300,178,282,61.30434782608696
"Census Tract 1614, Oakland County, Michigan",740,26,125,161400,261,479,64.72972972972974
"Census Tract 1615, Oakland County, Michigan",126,26,125,161500,0,126,100.0
"Census Tract 1616, Oakland County, Michigan",736,26,125,161600,119,617,83.83152173913044
"Census Tract 1617, Oakland County, Michigan",96,26,125,161700,12,84,87.5
"Census Tract 1618, Oakland County, Michigan",1257,26,125,161800,171,1086,86.39618138424821
"Census Tract 1619, Oakland County, Michigan",317,26,125,161900,13,304,95.89905362776025
"Census Tract 1620, Oakland County, Michigan",236,26,125,162000,15,221,93.64406779661016
"Census Tract 1621, Oakland County, Michigan",1529,26,125,162100,16,1513,98.95356442119032
"Census Tract 1622, Oakland County, Michigan",580,26,125,162200,30,550,94.82758620689656
"Census Tract 1623, Oakland County, Michigan",327,26,125,162300,22,305,93.27217125382263
"Census Tract 1624, Oakland County, Michigan",286,26,125,162400,48,238,83.21678321678321
"Census Tract 1625, Oakland County, Michigan",745,26,125,162500,45,700,93.95973154362416
"Census Tract 1650, Oakland County, Michigan",412,26,125,165000,264,148,35.92233009708738
"Census Tract 1651, Oakland County, Michigan",484,26,125,165100,329,155,32.02479338842975
"Census Tract 1652, Oakland County, Michigan",1016,26,125,165200,137,879,86.51574803149606
"Census Tract 1660, Oakland County, Michigan",421,26,125,166000,234,187,44.418052256532064
"Census Tract 1661, Oakland County, Michigan",687,26,125,166100,310,377,54.87627365356623
"Census Tract 1662, Oakland County, Michigan",44,26,125,166200,44,0,0.0
"Census Tract 1664, Oakland County, Michigan",55,26,125,166400,9,46,83.63636363636363
"Census Tract 1665, Oakland County, Michigan",104,26,125,166500,51,53,50.96153846153846
"Census Tract 1666, Oakland County, Michigan",1295,26,125,166600,590,705,54.440154440154444
"Census Tract 1667, Oakland County, Michigan",37,26,125,166700,5,32,86.48648648648648
"Census Tract 1668, Oakland County, Michigan",158,26,125,166800,135,23,14.556962025316455
"Census Tract 1669, Oakland County, Michigan",96,26,125,166900,35,61,63.541666666666664
"Census Tract 1670, Oakland County, Michigan",522,26,125,167000,143,379,72.60536398467433
"Census Tract 1673, Oakland County, Michigan",690,26,125,167300,361,329,47.68115942028985
"Census Tract 1674, Oakland County, Michigan",950,26,125,167400,518,432,45.473684210526315
"Census Tract 1675, Oakland County, Michigan",517,26,125,167500,280,237,45.84139264990329
"Census Tract 1678, Oakland County, Michigan",940,26,125,167800,416,524,55.74468085106383
"Census Tract 1679, Oakland County, Michigan",74,26,125,167900,26,48,64.86486486486487
"Census Tract 1681, Oakland County, Michigan",76,26,125,168100,36,40,52.63157894736842
"Census Tract 1684, Oakland County, Michigan",319,26,125,168400,83,236,73.98119122257053
"Census Tract 1685, Oakland County, Michigan",933,26,125,168500,448,485,51.982851018220785
"Census Tract 1686, Oakland County, Michigan",1217,26,125,168600,459,758,62.28430566967954
"Census Tract 1687, Oakland County, Michigan",506,26,125,168700,239,267,52.76679841897233
"Census Tract 1688, Oakland County, Michigan",63,26,125,168800,15,48,76.19047619047619
"Census Tract 1689, Oakland County, Michigan",3002,26,125,168900,780,2222,74.01732178547635
"Census Tract 1700, Oakland County, Michigan",9,26,125,170000,9,0,0.0
"Census Tract 1701, Oakland County, Michigan",220,26,125,170100,189,31,14.09090909090909
"Census Tract 1702, Oakland County, Michigan",281,26,125,170200,231,50,17.793594306049823
"Census Tract 1703, Oakland County, Michigan",104,26,125,170300,94,10,9.615384615384617
"Census Tract 1704, Oakland County, Michigan",608,26,125,170400,485,123,20.230263157894736
"Census Tract 1710, Oakland County, Michigan",1008,26,125,171000,680,328,32.53968253968254
"Census Tract 1711, Oakland County, Michigan",566,26,125,171100,284,282,49.82332155477032
"Census Tract 1712, Oakland County, Michigan",265,26,125,171200,84,181,68.30188679245282
"Census Tract 1713, Oakland County, Michigan",469,26,125,171300,38,431,91.89765458422174
"Census Tract 1714, Oakland County, Michigan",705,26,125,171400,97,608,86.24113475177305
"Census Tract 1715, Oakland County, Michigan",735,26,125,171500,19,716,97.41496598639455
"Census Tract 1716, Oakland County, Michigan",502,26,125,171600,212,290,57.76892430278885
"Census Tract 1724, Oakland County, Michigan",1107,26,125,172400,428,679,61.33694670280037
"Census Tract 1725, Oakland County, Michigan",723,26,125,172500,64,659,91.14799446749655
"Census Tract 1730, Oakland County, Michigan",819,26,125,173000,694,125,15.262515262515263
"Census Tract 1731, Oakland County, Michigan",422,26,125,173100,312,110,26.066350710900476
"Census Tract 1732, Oakland County, Michigan",273,26,125,173200,248,25,9.157509157509157
"Census Tract 1733, Oakland County, Michigan",164,26,125,173300,77,87,53.04878048780488
"Census Tract 1734, Oakland County, Michigan",624,26,125,173400,513,111,17.78846153846154
"Census Tract 1735, Oakland County, Michigan",687,26,125,173500,423,264,38.427947598253276
"Census Tract 1736, Oakland County, Michigan",308,26,125,173600,243,65,21.1038961038961
"Census Tract 1750, Oakland County, Michigan",706,26,125,175000,570,136,19.263456090651555
"Census Tract 1751, Oakland County, Michigan",1383,26,125,175100,986,397,28.705712219812003
"Census Tract 1752, Oakland County, Michigan",702,26,125,175200,558,144,20.51282051282051
"Census Tract 1753, Oakland County, Michigan",788,26,125,175300,603,185,23.477157360406093
"Census Tract 1800, Oakland County, Michigan",124,26,125,180000,78,46,37.096774193548384
"Census Tract 1801, Oakland County, Michigan",385,26,125,180100,369,16,4.1558441558441555
"Census Tract 1802, Oakland County, Michigan",653,26,125,180200,615,38,5.819295558958652
"Census Tract 1803, Oakland County, Michigan",426,26,125,180300,366,60,14.084507042253522
"Census Tract 1810, Oakland County, Michigan",2027,26,125,181000,967,1060,52.29403058707449
"Census Tract 1811, Oakland County, Michigan",170,26,125,181100,166,4,2.3529411764705883
"Census Tract 1812, Oakland County, Michigan",758,26,125,181200,564,194,25.593667546174142
"Census Tract 1813, Oakland County, Michigan",736,26,125,181300,489,247,33.559782608695656
"Census Tract 1814, Oakland County, Michigan",545,26,125,181400,328,217,39.816513761467895
"Census Tract 1815, Oakland County, Michigan",351,26,125,181500,282,69,19.65811965811966
"Census Tract 1816, Oakland County, Michigan",854,26,125,181600,669,185,21.662763466042154
"Census Tract 1830, Oakland County, Michigan",1079,26,125,183000,707,372,34.47636700648749
"Census Tract 1831, Oakland County, Michigan",342,26,125,183100,292,50,14.619883040935672
"Census Tract 1832, Oakland County, Michigan",901,26,125,183200,748,153,16.9811320754717
"Census Tract 1833, Oakland County, Michigan",478,26,125,183300,402,76,15.899581589958158
"Census Tract 1834, Oakland County, Michigan",352,26,125,183400,254,98,27.84090909090909
"Census Tract 1835, Oakland County, Michigan",612,26,125,183500,385,227,37.091503267973856
"Census Tract 1836, Oakland County, Michigan",506,26,125,183600,390,116,22.92490118577075
"Census Tract 1837, Oakland County, Michigan",752,26,125,183700,652,100,13.297872340425531
"Census Tract 1838, Oakland County, Michigan",542,26,125,183800,442,100,18.45018450184502
"Census Tract 1839, Oakland County, Michigan",366,26,125,183900,307,59,16.120218579234972
"Census Tract 1840, Oakland County, Michigan",264,26,125,184000,246,18,6.8181818181818175
"Census Tract 1841, Oakland County, Michigan",512,26,125,184100,435,77,15.0390625
"Census Tract 1842, Oakland County, Michigan",694,26,125,184200,508,186,26.801152737752158
"Census Tract 1843, Oakland County, Michigan",274,26,125,184300,190,84,30.656934306569344
"Census Tract 1844, Oakland County, Michigan",624,26,125,184400,532,92,14.743589743589745
"Census Tract 1845, Oakland County, Michigan",455,26,125,184500,436,19,4.175824175824175
"Census Tract 1846, Oakland County, Michigan",412,26,125,184600,368,44,10.679611650485436
"Census Tract 1847, Oakland County, Michigan",195,26,125,184700,139,56,28.717948717948715
"Census Tract 1870, Oakland County, Michigan",53,26,125,187000,41,12,22.641509433962266
"Census Tract 1880, Oakland County, Michigan",17,26,125,188000,17,0,0.0
"Census Tract 1881, Oakland County, Michigan",30,26,125,188100,30,0,0.0
"Census Tract 1902, Oakland County, Michigan",8,26,125,190200,8,0,0.0
"Census Tract 1904, Oakland County, Michigan",51,26,125,190400,51,0,0.0
"Census Tract 1905, Oakland County, Michigan",17,26,125,190500,17,0,0.0
"Census Tract 1907, Oakland County, Michigan",58,26,125,190700,49,9,15.517241379310345
"Census Tract 1908, Oakland County, Michigan",116,26,125,190800,116,0,0.0
"Census Tract 1910, Oakland County, Michigan",356,26,125,191000,324,32,8.98876404494382
"Census Tract 1911, Oakland County, Michigan",749,26,125,191100,654,95,12.683578104138851
"Census Tract 1912, Oakland County, Michigan",762,26,125,191200,677,85,11.15485564304462
"Census Tract 1913, Oakland County, Michigan",72,26,125,191300,40,32,44.44444444444444
"Census Tract 1920, Oakland County, Michigan",471,26,125,192000,434,37,7.855626326963907
"Census Tract 1922, Oakland County, Michigan",61,26,125,192200,53,8,13.114754098360656
"Census Tract 1924, Oakland County, Michigan",313,26,125,192400,248,65,20.766773162939298
"Census Tract 1925, Oakland County, Michigan",27,26,125,192500,27,0,0.0
"Census Tract 1927, Oakland County, Michigan",157,26,125,192700,129,28,17.8343949044586
"Census Tract 1928, Oakland County, Michigan",168,26,125,192800,102,66,39.285714285714285
"Census Tract 1930, Oakland County, Michigan",90,26,125,193000,64,26,28.888888888888886
"Census Tract 1931, Oakland County, Michigan",370,26,125,193100,242,128,34.5945945945946
"Census Tract 1933, Oakland County, Michigan",835,26,125,193300,450,385,46.10778443113773
"Census Tract 1934, Oakland County, Michigan",109,26,125,193400,87,22,20.18348623853211
"Census Tract 1935, Oakland County, Michigan",466,26,125,193500,335,131,28.11158798283262
"Census Tract 1936, Oakland County, Michigan",154,26,125,193600,125,29,18.83116883116883
"Census Tract 1937, Oakland County, Michigan",583,26,125,193700,409,174,29.845626072041163
"Census Tract 1940, Oakland County, Michigan",1500,26,125,194000,709,791,52.733333333333334
"Census Tract 1941, Oakland County, Michigan",24,26,125,194100,24,0,0.0
"Census Tract 1942, Oakland County, Michigan",61,26,125,194200,48,13,21.311475409836063
"Census Tract 1943, Oakland County, Michigan",366,26,125,194300,186,180,49.18032786885246
"Census Tract 1944, Oakland County, Michigan",409,26,125,194400,409,0,0.0
"Census Tract 1945, Oakland County, Michigan",147,26,125,194500,121,26,17.687074829931973
"Census Tract 1946, Oakland County, Michigan",334,26,125,194600,292,42,12.574850299401197
"Census Tract 1960, Oakland County, Michigan",102,26,125,196000,39,63,61.76470588235294
"Census Tract 1961, Oakland County, Michigan",251,26,125,196100,193,58,23.107569721115535
"Census Tract 1962, Oakland County, Michigan",154,26,125,196200,109,45,29.22077922077922
"Census Tract 1963, Oakland County, Michigan",89,26,125,196300,71,18,20.224719101123593
"Census Tract 1964, Oakland County, Michigan",7,26,125,196400,0,7,100.0
"Census Tract 1965, Oakland County, Michigan",207,26,125,196500,91,116,56.038647342995176
"Census Tract 1966, Oakland County, Michigan",51,26,125,196600,32,19,37.254901960784316
"Census Tract 1967, Oakland County, Michigan",17,26,125,196700,13,4,23.52941176470588
"Census Tract 1968, Oakland County, Michigan",60,26,125,196800,24,36,60.0
"Census Tract 1969, Oakland County, Michigan",240,26,125,196900,98,142,59.166666666666664
"Census Tract 1970, Oakland County, Michigan",95,26,125,197000,70,25,26.31578947368421
"Census Tract 1971, Oakland County, Michigan",78,26,125,197100,56,22,28.205128205128204
"Census Tract 1972, Oakland County, Michigan",192,26,125,197200,114,78,40.625
"Census Tract 1973, Oakland County, Michigan",536,26,125,197300,327,209,38.992537313432834
"Census Tract 1974, Oakland County, Michigan",440,26,125,197400,352,88,20.0
"Census Tract 1975, Oakland County, Michigan",1058,26,125,197500,324,734,69.37618147448015
"Census Tract 1976, Oakland County, Michigan",750,26,125,197600,387,363,48.4
"Census Tract 1977.01, Oakland County, Michigan",1730,26,125,197701,775,955,55.202312138728324
"Census Tract 1977.02, Oakland County, Michigan",923,26,125,197702,428,495,53.62946912242686
"Census Tract 1979, Oakland County, Michigan",47,26,125,197900,17,30,63.829787234042556
"Census Tract 1980, Oakland County, Michigan",88,26,125,198000,36,52,59.09090909090909
"Census Tract 1981, Oakland County, Michigan",1216,26,125,198100,612,604,49.67105263157895
"Census Tract 2067, Macomb County, Michigan",464,26,99,206700,366,98,21.120689655172413
"Census Tract 2100, Macomb County, Michigan",220,26,99,210000,220,0,0.0
"Census Tract 2110, Macomb County, Michigan",467,26,99,211000,366,101,21.627408993576015
"Census Tract 2120, Macomb County, Michigan",167,26,99,212000,164,3,1.7964071856287425
"Census Tract 2140, Macomb County, Michigan",81,26,99,214000,55,26,32.098765432098766
"Census Tract 2145, Macomb County, Michigan",104,26,99,214500,104,0,0.0
"Census Tract 2150, Macomb County, Michigan",202,26,99,215000,101,101,50.0
"Census Tract 2152, Macomb County, Michigan",186,26,99,215200,171,15,8.064516129032258
"Census Tract 2153, Macomb County, Michigan",734,26,99,215300,578,156,21.25340599455041
"Census Tract 2155, Macomb County, Michigan",373,26,99,215500,372,1,0.2680965147453083
"Census Tract 2160, Macomb County, Michigan",162,26,99,216000,162,0,0.0
"Census Tract 2170, Macomb County, Michigan",45,26,99,217000,35,10,22.22222222222222
"Census Tract 2180, Macomb County, Michigan",563,26,99,218000,468,95,16.873889875666073
"Census Tract 2200.01, Macomb County, Michigan",295,26,99,220001,264,31,10.508474576271185
"Census Tract 2200.02, Macomb County, Michigan",644,26,99,220002,586,58,9.006211180124224
"Census Tract 2211, Macomb County, Michigan",446,26,99,221100,399,47,10.538116591928251
"Census Tract 2212, Macomb County, Michigan",348,26,99,221200,255,93,26.72413793103448
"Census Tract 2215, Macomb County, Michigan",21,26,99,221500,21,0,0.0
"Census Tract 2218, Macomb County, Michigan",123,26,99,221800,123,0,0.0
"Census Tract 2221.01, Macomb County, Michigan",496,26,99,222101,321,175,35.28225806451613
"Census Tract 2221.02, Macomb County, Michigan",1200,26,99,222102,729,471,39.25
"Census Tract 2225, Macomb County, Michigan",340,26,99,222500,329,11,3.2352941176470593
"Census Tract 2228, Macomb County, Michigan",196,26,99,222800,155,41,20.918367346938776
"Census Tract 2234, Macomb County, Michigan",146,26,99,223400,146,0,0.0
"Census Tract 2235, Macomb County, Michigan",25,26,99,223500,25,0,0.0
"Census Tract 2238, Macomb County, Michigan",71,26,99,223800,71,0,0.0
"Census Tract 2239, Macomb County, Michigan",43,26,99,223900,17,26,60.46511627906976
"Census Tract 2240, Macomb County, Michigan",73,26,99,224000,43,30,41.0958904109589
"Census Tract 2241, Macomb County, Michigan",52,26,99,224100,52,0,0.0
"Census Tract 2242, Macomb County, Michigan",459,26,99,224200,337,122,26.57952069716776
"Census Tract 2243, Macomb County, Michigan",47,26,99,224300,47,0,0.0
"Census Tract 2244, Macomb County, Michigan",64,26,99,224400,64,0,0.0
"Census Tract 2245, Macomb County, Michigan",208,26,99,224500,122,86,41.34615384615385
"Census Tract 2246, Macomb County, Michigan",860,26,99,224600,605,255,29.651162790697676
"Census Tract 2251, Macomb County, Michigan",252,26,99,225100,204,48,19.047619047619047
"Census Tract 2252, Macomb County, Michigan",480,26,99,225200,319,161,33.541666666666664
"Census Tract 2253, Macomb County, Michigan",879,26,99,225300,834,45,5.1194539249146755
"Census Tract 2254, Macomb County, Michigan",182,26,99,225400,173,9,4.945054945054945
"Census Tract 2255, Macomb County, Michigan",408,26,99,225500,360,48,11.76470588235294
"Census Tract 2256, Macomb County, Michigan",878,26,99,225600,719,159,18.109339407744876
"Census Tract 2257.01, Macomb County, Michigan",2121,26,99,225701,1538,583,27.487034417727486
"Census Tract 2257.02, Macomb County, Michigan",66,26,99,225702,47,19,28.78787878787879
"Census Tract 2258, Macomb County, Michigan",459,26,99,225800,413,46,10.021786492374728
"Census Tract 2259, Macomb County, Michigan",250,26,99,225900,204,46,18.4
"Census Tract 2261, Macomb County, Michigan",106,26,99,226100,106,0,0.0
"Census Tract 2264, Macomb County, Michigan",61,26,99,226400,54,7,11.475409836065573
"Census Tract 2267, Macomb County, Michigan",135,26,99,226700,135,0,0.0
"Census Tract 2270, Macomb County, Michigan",42,26,99,227000,42,0,0.0
"Census Tract 2273, Macomb County, Michigan",702,26,99,227300,510,192,27.350427350427353
"Census Tract 2280, Macomb County, Michigan",552,26,99,228000,509,43,7.789855072463768
"Census Tract 2281, Macomb County, Michigan",437,26,99,228100,404,33,7.551487414187644
"Census Tract 2300, Macomb County, Michigan",1491,26,99,230000,1333,158,10.596914822266935
"Census Tract 2302, Macomb County, Michigan",115,26,99,230200,86,29,25.217391304347824
"Census Tract 2303, Macomb County, Michigan",469,26,99,230300,353,116,24.733475479744136
"Census Tract 2304, Macomb County, Michigan",271,26,99,230400,271,0,0.0
"Census Tract 2305, Macomb County, Michigan",675,26,99,230500,494,181,26.814814814814813
"Census Tract 2306.01, Macomb County, Michigan",857,26,99,230601,715,142,16.569428238039674
"Census Tract 2306.02, Macomb County, Michigan",295,26,99,230602,295,0,0.0
"Census Tract 2307, Macomb County, Michigan",92,26,99,230700,82,10,10.869565217391305
"Census Tract 2308, Macomb County, Michigan",352,26,99,230800,261,91,25.85227272727273
"Census Tract 2309, Macomb County, Michigan",965,26,99,230900,701,264,27.357512953367873
"Census Tract 2310, Macomb County, Michigan",220,26,99,231000,148,72,32.72727272727273
"Census Tract 2311, Macomb County, Michigan",577,26,99,231100,419,158,27.38301559792028
"Census Tract 2312, Macomb County, Michigan",634,26,99,231200,470,164,25.86750788643533
"Census Tract 2314, Macomb County, Michigan",299,26,99,231400,226,73,24.414715719063544
"Census Tract 2315, Macomb County, Michigan",205,26,99,231500,151,54,26.34146341463415
"Census Tract 2316, Macomb County, Michigan",1034,26,99,231600,595,439,42.456479690522244
"Census Tract 2317, Macomb County, Michigan",511,26,99,231700,364,147,28.767123287671232
"Census Tract 2318, Macomb County, Michigan",159,26,99,231800,121,38,23.89937106918239
"Census Tract 2319, Macomb County, Michigan",512,26,99,231900,497,15,2.9296875
"Census Tract 2320, Macomb County, Michigan",59,26,99,232000,33,26,44.06779661016949
"Census Tract 2321, Macomb County, Michigan",856,26,99,232100,358,498,58.177570093457945
"Census Tract 2322, Macomb County, Michigan",769,26,99,232200,447,322,41.87256176853056
"Census Tract 2323, Macomb County, Michigan",980,26,99,232300,740,240,24.489795918367346
"Census Tract 2324, Macomb County, Michigan",794,26,99,232400,581,213,26.82619647355164
"Census Tract 2325, Macomb County, Michigan",97,26,99,232500,71,26,26.804123711340207
"Census Tract 2330, Macomb County, Michigan",250,26,99,233000,215,35,14.000000000000002
"Census Tract 2400, Macomb County, Michigan",720,26,99,240000,259,461,64.02777777777777
"Census Tract 2403, Macomb County, Michigan",647,26,99,240300,492,155,23.956723338485318
"Census Tract 2404, Macomb County, Michigan",511,26,99,240400,455,56,10.95890410958904
"Census Tract 2405, Macomb County, Michigan",314,26,99,240500,226,88,28.02547770700637
"Census Tract 2406, Macomb County, Michigan",956,26,99,240600,488,468,48.95397489539749
"Census Tract 2407, Macomb County, Michigan",63,26,99,240700,49,14,22.22222222222222
"Census Tract 2408, Macomb County, Michigan",744,26,99,240800,371,373,50.134408602150536
"Census Tract 2409, Macomb County, Michigan",87,26,99,240900,82,5,5.747126436781609
"Census Tract 2410, Macomb County, Michigan",998,26,99,241000,322,676,67.73547094188376
"Census Tract 2412, Macomb County, Michigan",767,26,99,241200,439,328,42.76401564537158
"Census Tract 2413, Macomb County, Michigan",585,26,99,241300,359,226,38.63247863247864
"Census Tract 2414, Macomb County, Michigan",213,26,99,241400,134,79,37.08920187793427
"Census Tract 2415, Macomb County, Michigan",683,26,99,241500,463,220,32.210834553440705
"Census Tract 2416, Macomb County, Michigan",433,26,99,241600,158,275,63.51039260969977
"Census Tract 2417, Macomb County, Michigan",615,26,99,241700,321,294,47.80487804878049
"Census Tract 2418, Macomb County, Michigan",879,26,99,241800,189,690,78.49829351535837
"Census Tract 2419, Macomb County, Michigan",788,26,99,241900,462,326,41.370558375634516
"Census Tract 2420, Macomb County, Michigan",1822,26,99,242000,1149,673,36.93743139407245
"Census Tract 2421, Macomb County, Michigan",1175,26,99,242100,680,495,42.12765957446808
"Census Tract 2425, Macomb County, Michigan",1330,26,99,242500,861,469,35.26315789473684
"Census Tract 2430, Macomb County, Michigan",390,26,99,243000,261,129,33.07692307692307
"Census Tract 2435, Macomb County, Michigan",2163,26,99,243500,1437,726,33.56449375866852
"Census Tract 2440, Macomb County, Michigan",48,26,99,244000,43,5,10.416666666666668
"Census Tract 2450, Macomb County, Michigan",1183,26,99,245000,694,489,41.33558748943364
"Census Tract 2451, Macomb County, Michigan",666,26,99,245100,538,128,19.21921921921922
"Census Tract 2452, Macomb County, Michigan",492,26,99,245200,306,186,37.80487804878049
"Census Tract 2453, Macomb County, Michigan",489,26,99,245300,365,124,25.357873210633947
"Census Tract 2454, Macomb County, Michigan",190,26,99,245400,71,119,62.63157894736842
"Census Tract 2471, Macomb County, Michigan",113,26,99,247100,84,29,25.663716814159294
"Census Tract 2472, Macomb County, Michigan",667,26,99,247200,413,254,38.08095952023988
"Census Tract 2473, Macomb County, Michigan",619,26,99,247300,497,122,19.7092084006462
"Census Tract 2474, Macomb County, Michigan",130,26,99,247400,95,35,26.923076923076923
"Census Tract 2475, Macomb County, Michigan",554,26,99,247500,456,98,17.689530685920577
"Census Tract 2476.01, Macomb County, Michigan",793,26,99,247601,392,401,50.56746532156369
"Census Tract 2476.02, Macomb County, Michigan",919,26,99,247602,637,282,30.68552774755169
"Census Tract 2500, Macomb County, Michigan",71,26,99,250000,53,18,25.352112676056336
"Census Tract 2501, Macomb County, Michigan",204,26,99,250100,191,13,6.372549019607843
"Census Tract 2502, Macomb County, Michigan",175,26,99,250200,150,25,14.285714285714285
"Census Tract 2503, Macomb County, Michigan",254,26,99,250300,204,50,19.68503937007874
"Census Tract 2504, Macomb County, Michigan",58,26,99,250400,43,15,25.862068965517242
"Census Tract 2505, Macomb County, Michigan",98,26,99,250500,98,0,0.0
"Census Tract 2506, Macomb County, Michigan",316,26,99,250600,276,40,12.658227848101266
"Census Tract 2507, Macomb County, Michigan",216,26,99,250700,160,56,25.925925925925924
"Census Tract 2508, Macomb County, Michigan",277,26,99,250800,189,88,31.768953068592058
"Census Tract 2509, Macomb County, Michigan",131,26,99,250900,100,31,23.66412213740458
"Census Tract 2510, Macomb County, Michigan",129,26,99,251000,110,19,14.728682170542637
"Census Tract 2511, Macomb County, Michigan",77,26,99,251100,54,23,29.87012987012987
"Census Tract 2512, Macomb County, Michigan",170,26,99,251200,149,21,12.352941176470589
"Census Tract 2513, Macomb County, Michigan",79,26,99,251300,64,15,18.9873417721519
"Census Tract 2514, Macomb County, Michigan",158,26,99,251400,151,7,4.430379746835443
"Census Tract 2515, Macomb County, Michigan",200,26,99,251500,135,65,32.5
"Census Tract 2516, Macomb County, Michigan",572,26,99,251600,458,114,19.93006993006993
"Census Tract 2517, Macomb County, Michigan",439,26,99,251700,307,132,30.068337129840543
"Census Tract 2518, Macomb County, Michigan",422,26,99,251800,209,213,50.4739336492891
"Census Tract 2519, Macomb County, Michigan",204,26,99,251900,184,20,9.803921568627452
"Census Tract 2520, Macomb County, Michigan",269,26,99,252000,234,35,13.011152416356877
"Census Tract 2521, Macomb County, Michigan",122,26,99,252100,101,21,17.21311475409836
"Census Tract 2522, Macomb County, Michigan",503,26,99,252200,395,108,21.47117296222664
"Census Tract 2540, Macomb County, Michigan",186,26,99,254000,141,45,24.193548387096776
"Census Tract 2541, Macomb County, Michigan",571,26,99,254100,489,82,14.36077057793345
"Census Tract 2542, Macomb County, Michigan",384,26,99,254200,318,66,17.1875
"Census Tract 2545, Macomb County, Michigan",421,26,99,254500,364,57,13.539192399049881
"Census Tract 2550, Macomb County, Michigan",915,26,99,255000,374,541,59.12568306010929
"Census Tract 2551, Macomb County, Michigan",583,26,99,255100,363,220,37.735849056603776
"Census Tract 2552, Macomb County, Michigan",1443,26,99,255200,714,729,50.51975051975052
"Census Tract 2553, Macomb County, Michigan",713,26,99,255300,310,403,56.52173913043478
"Census Tract 2554, Macomb County, Michigan",127,26,99,255400,84,43,33.85826771653544
"Census Tract 2555, Macomb County, Michigan",147,26,99,255500,108,39,26.53061224489796
"Census Tract 2556, Macomb County, Michigan",349,26,99,255600,232,117,33.5243553008596
"Census Tract 2557, Macomb County, Michigan",294,26,99,255700,171,123,41.83673469387755
"Census Tract 2558, Macomb County, Michigan",291,26,99,255800,114,177,60.824742268041234
"Census Tract 2559, Macomb County, Michigan",226,26,99,255900,137,89,39.38053097345133
"Census Tract 2560, Macomb County, Michigan",282,26,99,256000,169,113,40.0709219858156
"Census Tract 2561, Macomb County, Michigan",409,26,99,256100,253,156,38.141809290953546
"Census Tract 2562, Macomb County, Michigan",243,26,99,256200,175,68,27.983539094650205
"Census Tract 2563, Macomb County, Michigan",296,26,99,256300,112,184,62.16216216216216
"Census Tract 2564, Macomb County, Michigan",138,26,99,256400,90,48,34.78260869565217
"Census Tract 2565, Macomb County, Michigan",125,26,99,256500,74,51,40.8
"Census Tract 2566, Macomb County, Michigan",445,26,99,256600,274,171,38.42696629213483
"Census Tract 2567, Macomb County, Michigan",193,26,99,256700,118,75,38.860103626943
"Census Tract 2568, Macomb County, Michigan",162,26,99,256800,117,45,27.77777777777778
"Census Tract 2580, Macomb County, Michigan",297,26,99,258000,87,210,70.70707070707071
"Census Tract 2581, Macomb County, Michigan",492,26,99,258100,171,321,65.2439024390244
"Census Tract 2582, Macomb County, Michigan",333,26,99,258200,123,210,63.06306306306306
"Census Tract 2583, Macomb County, Michigan",474,26,99,258300,156,318,67.08860759493672
"Census Tract 2584, Macomb County, Michigan",936,26,99,258400,261,675,72.11538461538461
"Census Tract 2585, Macomb County, Michigan",226,26,99,258500,103,123,54.424778761061944
"Census Tract 2586, Macomb County, Michigan",728,26,99,258600,259,469,64.42307692307693
"Census Tract 2587, Macomb County, Michigan",310,26,99,258700,94,216,69.6774193548387
"Census Tract 2588, Macomb County, Michigan",355,26,99,258800,36,319,89.85915492957747
"Census Tract 2589, Macomb County, Michigan",394,26,99,258900,92,302,76.6497461928934
"Census Tract 2600, Macomb County, Michigan",133,26,99,260000,96,37,27.819548872180448
"Census Tract 2601, Macomb County, Michigan",623,26,99,260100,320,303,48.635634028892454
"Census Tract 2602, Macomb County, Michigan",49,26,99,260200,40,9,18.367346938775512
"Census Tract 2603, Macomb County, Michigan",71,26,99,260300,44,27,38.028169014084504
"Census Tract 2604, Macomb County, Michigan",214,26,99,260400,124,90,42.05607476635514
"Census Tract 2606, Macomb County, Michigan",295,26,99,260600,219,76,25.76271186440678
"Census Tract 2607, Macomb County, Michigan",318,26,99,260700,198,120,37.735849056603776
"Census Tract 2608, Macomb County, Michigan",153,26,99,260800,107,46,30.065359477124183
"Census Tract 2609, Macomb County, Michigan",295,26,99,260900,102,193,65.42372881355932
"Census Tract 2610, Macomb County, Michigan",223,26,99,261000,164,59,26.45739910313901
"Census Tract 2611, Macomb County, Michigan",767,26,99,261100,437,330,43.02477183833116
"Census Tract 2612, Macomb County, Michigan",204,26,99,261200,71,133,65.19607843137256
"Census Tract 2613, Macomb County, Michigan",78,26,99,261300,37,41,52.56410256410257
"Census Tract 2614, Macomb County, Michigan",59,26,99,261400,59,0,0.0
"Census Tract 2615, Macomb County, Michigan",685,26,99,261500,337,348,50.802919708029194
"Census Tract 2616, Macomb County, Michigan",12,26,99,261600,12,0,0.0
"Census Tract 2617, Macomb County, Michigan",698,26,99,261700,224,474,67.90830945558739
"Census Tract 2618, Macomb County, Michigan",40,26,99,261800,17,23,57.49999999999999
"Census Tract 2619, Macomb County, Michigan",285,26,99,261900,206,79,27.719298245614034
"Census Tract 2620, Macomb County, Michigan",136,26,99,262000,66,70,51.470588235294116
"Census Tract 2621, Macomb County, Michigan",179,26,99,262100,115,64,35.754189944134076
"Census Tract 2622, Macomb County, Michigan",100,26,99,262200,88,12,12.0
"Census Tract 2623, Macomb County, Michigan",901,26,99,262300,422,479,53.163152053274146
"Census Tract 2624, Macomb County, Michigan",350,26,99,262400,307,43,12.285714285714286
"Census Tract 2625, Macomb County, Michigan",707,26,99,262500,433,274,38.75530410183875
"Census Tract 2626, Macomb County, Michigan",541,26,99,262600,317,224,41.40480591497228
"Census Tract 2627, Macomb County, Michigan",523,26,99,262700,232,291,55.64053537284895
"Census Tract 2628, Macomb County, Michigan",555,26,99,262800,176,379,68.28828828828829
"Census Tract 2629, Macomb County, Michigan",509,26,99,262900,356,153,30.05893909626719
"Census Tract 2632, Macomb County, Michigan",620,26,99,263200,352,268,43.225806451612904
"Census Tract 2634, Macomb County, Michigan",229,26,99,263400,125,104,45.414847161572055
"Census Tract 2635, Macomb County, Michigan",453,26,99,263500,302,151,33.33333333333333
"Census Tract 2636, Macomb County, Michigan",920,26,99,263600,246,674,73.26086956521739
"Census Tract 2637, Macomb County, Michigan",715,26,99,263700,239,476,66.57342657342657
"Census Tract 2638, Macomb County, Michigan",607,26,99,263800,197,410,67.54530477759472
"Census Tract 2639, Macomb County, Michigan",721,26,99,263900,337,384,53.25936199722607
"Census Tract 2640, Macomb County, Michigan",492,26,99,264000,92,400,81.30081300813008
"Census Tract 2642, Macomb County, Michigan",780,26,99,264200,221,559,71.66666666666667
"Census Tract 2676, Macomb County, Michigan",24,26,99,267600,24,0,0.0
"Census Tract 2680, Macomb County, Michigan",1307,26,99,268000,955,352,26.931905126243304
"Census Tract 2681, Macomb County, Michigan",497,26,99,268100,217,280,56.33802816901409
"Census Tract 2682, Macomb County, Michigan",172,26,99,268200,172,0,0.0
"Census Tract 2683, Macomb County, Michigan",520,26,99,268300,227,293,56.34615384615385
"Census Tract 2684, Macomb County, Michigan",779,26,99,268400,467,312,40.05134788189987
"Census Tract 2803, Bay County, Michigan",406,26,17,280300,246,160,39.40886699507389
"Census Tract 2804, Bay County, Michigan",576,26,17,280400,500,76,13.194444444444445
"Census Tract 2805, Bay County, Michigan",173,26,17,280500,173,0,0.0
"Census Tract 2806, Bay County, Michigan",195,26,17,280600,149,46,23.589743589743588
"Census Tract 2807, Bay County, Michigan",725,26,17,280700,647,78,10.758620689655173
"Census Tract 2808, Bay County, Michigan",265,26,17,280800,221,44,16.60377358490566
"Census Tract 2809, Bay County, Michigan",305,26,17,280900,256,49,16.065573770491802
"Census Tract 2810, Bay County, Michigan",356,26,17,281000,271,85,23.876404494382022
"Census Tract 2813, Bay County, Michigan",254,26,17,281300,173,81,31.88976377952756
"Census Tract 2851, Bay County, Michigan",178,26,17,285100,146,32,17.97752808988764
"Census Tract 2852.01, Bay County, Michigan",1199,26,17,285201,995,204,17.01417848206839
"Census Tract 2852.02, Bay County, Michigan",467,26,17,285202,434,33,7.066381156316917
"Census Tract 2853, Bay County, Michigan",136,26,17,285300,101,35,25.735294117647058
"Census Tract 2854, Bay County, Michigan",412,26,17,285400,360,52,12.62135922330097
"Census Tract 2855, Bay County, Michigan",364,26,17,285500,323,41,11.263736263736265
"Census Tract 2856, Bay County, Michigan",635,26,17,285600,565,70,11.023622047244094
"Census Tract 2857, Bay County, Michigan",75,26,17,285700,75,0,0.0
"Census Tract 2858, Bay County, Michigan",933,26,17,285800,855,78,8.360128617363344
"Census Tract 2859, Bay County, Michigan",667,26,17,285900,582,85,12.743628185907047
"Census Tract 2860, Bay County, Michigan",73,26,17,286000,73,0,0.0
"Census Tract 2861, Bay County, Michigan",282,26,17,286100,282,0,0.0
"Census Tract 2862, Bay County, Michigan",103,26,17,286200,91,12,11.650485436893204
"Census Tract 2863, Bay County, Michigan",205,26,17,286300,194,11,5.365853658536586
"Census Tract 2864, Bay County, Michigan",106,26,17,286400,101,5,4.716981132075472
"Census Tract 2865, Bay County, Michigan",505,26,17,286500,404,101,20.0
"Census Tract 2866, Bay County, Michigan",707,26,17,286600,643,64,9.052333804809052
"Census Tract 2901, Midland County, Michigan",689,26,111,290100,666,23,3.3381712626995643
"Census Tract 2902, Midland County, Michigan",1084,26,111,290200,946,138,12.730627306273062
"Census Tract 2903, Midland County, Michigan",180,26,111,290300,180,0,0.0
"Census Tract 2904, Midland County, Michigan",92,26,111,290400,92,0,0.0
"Census Tract 2905, Midland County, Michigan",92,26,111,290500,92,0,0.0
"Census Tract 2906, Midland County, Michigan",503,26,111,290600,447,56,11.133200795228628
"Census Tract 2907, Midland County, Michigan",1085,26,111,290700,860,225,20.737327188940093
"Census Tract 2908, Midland County, Michigan",366,26,111,290800,319,47,12.841530054644808
"Census Tract 2909, Midland County, Michigan",719,26,111,290900,568,151,21.001390820584145
"Census Tract 2910, Midland County, Michigan",1107,26,111,291000,866,241,21.77055103884372
"Census Tract 2911.01, Midland County, Michigan",106,26,111,291101,106,0,0.0
"Census Tract 2911.02, Midland County, Michigan",373,26,111,291102,341,32,8.579088471849866
"Census Tract 2912, Midland County, Michigan",304,26,111,291200,304,0,0.0
"Census Tract 2913, Midland County, Michigan",178,26,111,291300,178,0,0.0
"Census Tract 2914, Midland County, Michigan",180,26,111,291400,155,25,13.88888888888889
"Census Tract 2915, Midland County, Michigan",277,26,111,291500,235,42,15.162454873646208
"Census Tract 2916.01, Midland County, Michigan",97,26,111,291601,97,0,0.0
"Census Tract 2916.02, Midland County, Michigan",243,26,111,291602,241,2,0.823045267489712
"Census Tract 2917, Midland County, Michigan",327,26,111,291700,306,21,6.422018348623854
"Census Tract 3300, Lapeer County, Michigan",183,26,87,330000,166,17,9.289617486338798
"Census Tract 3305, Lapeer County, Michigan",124,26,87,330500,124,0,0.0
"Census Tract 3310, Lapeer County, Michigan",86,26,87,331000,86,0,0.0
"Census Tract 3315, Lapeer County, Michigan",125,26,87,331500,125,0,0.0
"Census Tract 3320, Lapeer County, Michigan",203,26,87,332000,203,0,0.0
"Census Tract 3325, Lapeer County, Michigan",351,26,87,332500,351,0,0.0
"Census Tract 3330, Lapeer County, Michigan",66,26,87,333000,66,0,0.0
"Census Tract 3335, Lapeer County, Michigan",176,26,87,333500,99,77,43.75
"Census Tract 3340, Lapeer County, Michigan",160,26,87,334000,152,8,5.0
"Census Tract 3345, Lapeer County, Michigan",47,26,87,334500,45,2,4.25531914893617
"Census Tract 3360, Lapeer County, Michigan",131,26,87,336000,131,0,0.0
"Census Tract 3365, Lapeer County, Michigan",0,26,87,336500,0,0,
"Census Tract 3370, Lapeer County, Michigan",964,26,87,337000,917,47,4.875518672199171
"Census Tract 3375, Lapeer County, Michigan",606,26,87,337500,584,22,3.6303630363036308
"Census Tract 3380, Lapeer County, Michigan",202,26,87,338000,195,7,3.4653465346534658
"Census Tract 3385, Lapeer County, Michigan",158,26,87,338500,135,23,14.556962025316455
"Census Tract 3390, Lapeer County, Michigan",70,26,87,339000,66,4,5.714285714285714
"Census Tract 3395, Lapeer County, Michigan",820,26,87,339500,661,159,19.390243902439025
"Census Tract 3400, Lapeer County, Michigan",106,26,87,340000,106,0,0.0
"Census Tract 3405, Lapeer County, Michigan",178,26,87,340500,178,0,0.0
"Census Tract 3410, Lapeer County, Michigan",209,26,87,341000,209,0,0.0
"Census Tract 3415, Lapeer County, Michigan",290,26,87,341500,284,6,2.0689655172413794
"Census Tract 3420, Lapeer County, Michigan",63,26,87,342000,48,15,23.809523809523807
"Census Tract 3421, Lapeer County, Michigan",92,26,87,342100,92,0,0.0
"Census Tract 3801, Wexford County, Michigan",383,26,165,380100,367,16,4.177545691906006
"Census Tract 3802, Wexford County, Michigan",280,26,165,380200,264,16,5.714285714285714
"Census Tract 3803, Wexford County, Michigan",150,26,165,380300,144,6,4.0
"Census Tract 3804, Wexford County, Michigan",176,26,165,380400,171,5,2.840909090909091
"Census Tract 3805, Wexford County, Michigan",611,26,165,380500,611,0,0.0
"Census Tract 3806, Wexford County, Michigan",199,26,165,380600,199,0,0.0
"Census Tract 3807, Wexford County, Michigan",611,26,165,380700,561,50,8.183306055646481
"Census Tract 3808, Wexford County, Michigan",595,26,165,380800,533,62,10.420168067226891
"Census Tract 4001, Washtenaw County, Michigan",1150,26,161,400100,743,407,35.391304347826086
"Census Tract 4002, Washtenaw County, Michigan",90,26,161,400200,76,14,15.555555555555555
"Census Tract 4003, Washtenaw County, Michigan",1887,26,161,400300,1465,422,22.363540010598832
"Census Tract 4004, Washtenaw County, Michigan",352,26,161,400400,324,28,7.954545454545454
"Census Tract 4005, Washtenaw County, Michigan",2268,26,161,400500,1592,676,29.80599647266314
"Census Tract 4006, Washtenaw County, Michigan",1170,26,161,400600,1027,143,12.222222222222221
"Census Tract 4007, Washtenaw County, Michigan",824,26,161,400700,673,151,18.325242718446603
"Census Tract 4008, Washtenaw County, Michigan",1177,26,161,400800,784,393,33.38997451146984
"Census Tract 4021, Washtenaw County, Michigan",1207,26,161,402100,628,579,47.970173985086994
"Census Tract 4022, Washtenaw County, Michigan",1159,26,161,402200,486,673,58.06729939603106
"Census Tract 4023, Washtenaw County, Michigan",176,26,161,402300,145,31,17.613636363636363
"Census Tract 4025, Washtenaw County, Michigan",655,26,161,402500,250,405,61.832061068702295
"Census Tract 4026, Washtenaw County, Michigan",431,26,161,402600,155,276,64.03712296983758
"Census Tract 4027, Washtenaw County, Michigan",791,26,161,402700,462,329,41.5929203539823
"Census Tract 4031, Washtenaw County, Michigan",11,26,161,403100,11,0,0.0
"Census Tract 4032, Washtenaw County, Michigan",290,26,161,403200,260,30,10.344827586206897
"Census Tract 4033, Washtenaw County, Michigan",600,26,161,403300,423,177,29.5
"Census Tract 4034, Washtenaw County, Michigan",299,26,161,403400,257,42,14.046822742474916
"Census Tract 4035, Washtenaw County, Michigan",673,26,161,403500,537,136,20.208023774145616
"Census Tract 4036, Washtenaw County, Michigan",1752,26,161,403600,631,1121,63.98401826484018
"Census Tract 4038, Washtenaw County, Michigan",677,26,161,403800,375,302,44.608567208271786
"Census Tract 4041, Washtenaw County, Michigan",489,26,161,404100,320,169,34.56032719836401
"Census Tract 4042, Washtenaw County, Michigan",775,26,161,404200,532,243,31.35483870967742
"Census Tract 4043, Washtenaw County, Michigan",81,26,161,404300,49,32,39.50617283950617
"Census Tract 4044, Washtenaw County, Michigan",211,26,161,404400,138,73,34.59715639810427
"Census Tract 4045, Washtenaw County, Michigan",2121,26,161,404500,1571,550,25.93116454502593
"Census Tract 4046, Washtenaw County, Michigan",1249,26,161,404600,718,531,42.514011208967176
"Census Tract 4051, Washtenaw County, Michigan",543,26,161,405100,386,157,28.913443830570902
"Census Tract 4052, Washtenaw County, Michigan",865,26,161,405200,586,279,32.25433526011561
"Census Tract 4053, Washtenaw County, Michigan",310,26,161,405300,212,98,31.61290322580645
"Census Tract 4054, Washtenaw County, Michigan",124,26,161,405400,124,0,0.0
"Census Tract 4055, Washtenaw County, Michigan",299,26,161,405500,225,74,24.74916387959866
"Census Tract 4056, Washtenaw County, Michigan",1534,26,161,405600,804,730,47.58800521512386
"Census Tract 4060, Washtenaw County, Michigan",567,26,161,406000,406,161,28.39506172839506
"Census Tract 4070, Washtenaw County, Michigan",232,26,161,407000,156,76,32.758620689655174
"Census Tract 4074, Washtenaw County, Michigan",936,26,161,407400,159,777,83.01282051282051
"Census Tract 4076, Washtenaw County, Michigan",100,26,161,407600,30,70,70.0
"Census Tract 4101, Washtenaw County, Michigan",1584,26,161,410100,600,984,62.121212121212125
"Census Tract 4102, Washtenaw County, Michigan",598,26,161,410200,317,281,46.98996655518395
"Census Tract 4103, Washtenaw County, Michigan",1132,26,161,410300,865,267,23.586572438162545
"Census Tract 4104, Washtenaw County, Michigan",453,26,161,410400,121,332,73.28918322295806
"Census Tract 4105, Washtenaw County, Michigan",863,26,161,410500,262,601,69.64078794901506
"Census Tract 4106, Washtenaw County, Michigan",591,26,161,410600,189,402,68.02030456852792
"Census Tract 4107, Washtenaw County, Michigan",452,26,161,410700,268,184,40.707964601769916
"Census Tract 4108, Washtenaw County, Michigan",494,26,161,410800,224,270,54.655870445344135
"Census Tract 4109, Washtenaw County, Michigan",123,26,161,410900,88,35,28.455284552845526
"Census Tract 4110, Washtenaw County, Michigan",1248,26,161,411000,836,412,33.01282051282051
"Census Tract 4111, Washtenaw County, Michigan",69,26,161,411100,16,53,76.81159420289855
"Census Tract 4112, Washtenaw County, Michigan",1066,26,161,411200,367,699,65.57223264540337
"Census Tract 4117, Washtenaw County, Michigan",75,26,161,411700,38,37,49.333333333333336
"Census Tract 4119, Washtenaw County, Michigan",1032,26,161,411900,493,539,52.22868217054264
"Census Tract 4120, Washtenaw County, Michigan",673,26,161,412000,296,377,56.01783060921248
"Census Tract 4121, Washtenaw County, Michigan",440,26,161,412100,244,196,44.54545454545455
"Census Tract 4123, Washtenaw County, Michigan",306,26,161,412300,30,276,90.19607843137256
"Census Tract 4126, Washtenaw County, Michigan",1250,26,161,412600,730,520,41.6
"Census Tract 4127, Washtenaw County, Michigan",945,26,161,412700,642,303,32.06349206349206
"Census Tract 4130, Washtenaw County, Michigan",571,26,161,413000,189,382,66.90017513134852
"Census Tract 4132, Washtenaw County, Michigan",438,26,161,413200,158,280,63.926940639269404
"Census Tract 4134.01, Washtenaw County, Michigan",94,26,161,413401,32,62,65.95744680851064
"Census Tract 4134.02, Washtenaw County, Michigan",91,26,161,413402,40,51,56.043956043956044
"Census Tract 4134.03, Washtenaw County, Michigan",27,26,161,413403,21,6,22.22222222222222
"Census Tract 4140, Washtenaw County, Michigan",1616,26,161,414000,814,802,49.62871287128713
"Census Tract 4142, Washtenaw County, Michigan",822,26,161,414200,373,449,54.62287104622872
"Census Tract 4143, Washtenaw County, Michigan",1225,26,161,414300,635,590,48.16326530612245
"Census Tract 4145, Washtenaw County, Michigan",42,26,161,414500,34,8,19.047619047619047
"Census Tract 4147, Washtenaw County, Michigan",525,26,161,414700,408,117,22.285714285714285
"Census Tract 4149, Washtenaw County, Michigan",177,26,161,414900,108,69,38.983050847457626
"Census Tract 4152, Washtenaw County, Michigan",1047,26,161,415200,700,347,33.14231136580707
"Census Tract 4154, Washtenaw County, Michigan",411,26,161,415400,286,125,30.413625304136254
"Census Tract 4156, Washtenaw County, Michigan",74,26,161,415600,74,0,0.0
"Census Tract 4158, Washtenaw County, Michigan",17,26,161,415800,9,8,47.05882352941176
"Census Tract 4160, Washtenaw County, Michigan",74,26,161,416000,23,51,68.91891891891892
"Census Tract 4162, Washtenaw County, Michigan",273,26,161,416200,203,70,25.64102564102564
"Census Tract 4200, Washtenaw County, Michigan",79,26,161,420000,35,44,55.69620253164557
"Census Tract 4202, Washtenaw County, Michigan",191,26,161,420200,191,0,0.0
"Census Tract 4211, Washtenaw County, Michigan",312,26,161,421100,303,9,2.8846153846153846
"Census Tract 4219, Washtenaw County, Michigan",10,26,161,421900,4,6,60.0
"Census Tract 4222, Washtenaw County, Michigan",290,26,161,422200,290,0,0.0
"Census Tract 4229, Washtenaw County, Michigan",0,26,161,422900,0,0,
"Census Tract 4234, Washtenaw County, Michigan",542,26,161,423400,542,0,0.0
"Census Tract 4236, Washtenaw County, Michigan",364,26,161,423600,313,51,14.010989010989011
"Census Tract 4250, Washtenaw County, Michigan",41,26,161,425000,41,0,0.0
"Census Tract 4260, Washtenaw County, Michigan",108,26,161,426000,95,13,12.037037037037036
"Census Tract 4310, Washtenaw County, Michigan",322,26,161,431000,316,6,1.8633540372670807
"Census Tract 4320, Washtenaw County, Michigan",155,26,161,432000,137,18,11.612903225806452
"Census Tract 4440, Washtenaw County, Michigan",139,26,161,444000,122,17,12.23021582733813
"Census Tract 4450, Washtenaw County, Michigan",59,26,161,445000,52,7,11.864406779661017
"Census Tract 4462, Washtenaw County, Michigan",391,26,161,446200,391,0,0.0
"Census Tract 4464, Washtenaw County, Michigan",297,26,161,446400,290,7,2.356902356902357
"Census Tract 4470, Washtenaw County, Michigan",122,26,161,447000,122,0,0.0
"Census Tract 4480, Washtenaw County, Michigan",120,26,161,448000,104,16,13.333333333333334
"Census Tract 4530, Washtenaw County, Michigan",60,26,161,453000,60,0,0.0
"Census Tract 4540, Washtenaw County, Michigan",400,26,161,454000,356,44,11.0
"Census Tract 4550, Washtenaw County, Michigan",472,26,161,455000,415,57,12.076271186440678
"Census Tract 4560, Washtenaw County, Michigan",537,26,161,456000,456,81,15.083798882681565
"Census Tract 4610, Washtenaw County, Michigan",133,26,161,461000,133,0,0.0
"Census Tract 4640, Washtenaw County, Michigan",166,26,161,464000,142,24,14.457831325301203
"Census Tract 4650, Washtenaw County, Michigan",513,26,161,465000,513,0,0.0
"Census Tract 4660, Washtenaw County, Michigan",97,26,161,466000,91,6,6.185567010309279
"Census Tract 5001, Wayne County, Michigan",954,26,163,500100,11,943,98.84696016771488
"Census Tract 5002, Wayne County, Michigan",687,26,163,500200,0,687,100.0
"Census Tract 5003, Wayne County, Michigan",577,26,163,500300,4,573,99.30675909878683
"Census Tract 5004, Wayne County, Michigan",220,26,163,500400,0,220,100.0
"Census Tract 5005, Wayne County, Michigan",345,26,163,500500,0,345,100.0
"Census Tract 5006, Wayne County, Michigan",679,26,163,500600,0,679,100.0
"Census Tract 5007, Wayne County, Michigan",763,26,163,500700,0,763,100.0
"Census Tract 5008, Wayne County, Michigan",437,26,163,500800,7,430,98.39816933638444
"Census Tract 5009, Wayne County, Michigan",622,26,163,500900,52,570,91.63987138263666
"Census Tract 5010, Wayne County, Michigan",467,26,163,501000,32,435,93.14775160599572
"Census Tract 5011, Wayne County, Michigan",554,26,163,501100,15,539,97.29241877256317
"Census Tract 5012, Wayne County, Michigan",363,26,163,501200,5,358,98.62258953168043
"Census Tract 5013, Wayne County, Michigan",461,26,163,501300,16,445,96.52928416485899
"Census Tract 5014, Wayne County, Michigan",425,26,163,501400,10,415,97.6470588235294
"Census Tract 5015, Wayne County, Michigan",537,26,163,501500,0,537,100.0
"Census Tract 5016, Wayne County, Michigan",425,26,163,501600,56,369,86.82352941176471
"Census Tract 5017, Wayne County, Michigan",381,26,163,501700,44,337,88.4514435695538
"Census Tract 5018, Wayne County, Michigan",430,26,163,501800,93,337,78.37209302325581
"Census Tract 5019, Wayne County, Michigan",422,26,163,501900,33,389,92.18009478672985
"Census Tract 5020, Wayne County, Michigan",249,26,163,502000,0,249,100.0
"Census Tract 5031, Wayne County, Michigan",670,26,163,503100,3,667,99.55223880597015
"Census Tract 5032, Wayne County, Michigan",686,26,163,503200,32,654,95.33527696793003
"Census Tract 5033, Wayne County, Michigan",1025,26,163,503300,0,1025,100.0
"Census Tract 5034, Wayne County, Michigan",216,26,163,503400,0,216,100.0
"Census Tract 5035, Wayne County, Michigan",620,26,163,503500,0,620,100.0
"Census Tract 5036, Wayne County, Michigan",292,26,163,503600,10,282,96.57534246575342
"Census Tract 5039, Wayne County, Michigan",335,26,163,503900,7,328,97.91044776119404
"Census Tract 5040, Wayne County, Michigan",196,26,163,504000,0,196,100.0
"Census Tract 5041, Wayne County, Michigan",265,26,163,504100,0,265,100.0
"Census Tract 5042, Wayne County, Michigan",275,26,163,504200,30,245,89.0909090909091
"Census Tract 5043, Wayne County, Michigan",307,26,163,504300,12,295,96.09120521172639
"Census Tract 5044, Wayne County, Michigan",150,26,163,504400,0,150,100.0
"Census Tract 5047, Wayne County, Michigan",283,26,163,504700,0,283,100.0
"Census Tract 5048, Wayne County, Michigan",110,26,163,504800,0,110,100.0
"Census Tract 5049, Wayne County, Michigan",683,26,163,504900,0,683,100.0
"Census Tract 5050, Wayne County, Michigan",174,26,163,505000,0,174,100.0
"Census Tract 5051, Wayne County, Michigan",1056,26,163,505100,22,1034,97.91666666666666
"Census Tract 5052, Wayne County, Michigan",834,26,163,505200,7,827,99.16067146282974
"Census Tract 5054, Wayne County, Michigan",437,26,163,505400,18,419,95.88100686498856
"Census Tract 5055, Wayne County, Michigan",185,26,163,505500,0,185,100.0
"Census Tract 5061, Wayne County, Michigan",318,26,163,506100,16,302,94.9685534591195
"Census Tract 5062, Wayne County, Michigan",200,26,163,506200,7,193,96.5
"Census Tract 5063, Wayne County, Michigan",215,26,163,506300,2,213,99.06976744186046
"Census Tract 5064, Wayne County, Michigan",106,26,163,506400,8,98,92.45283018867924
"Census Tract 5065, Wayne County, Michigan",272,26,163,506500,0,272,100.0
"Census Tract 5066, Wayne County, Michigan",564,26,163,506600,13,551,97.69503546099291
"Census Tract 5067, Wayne County, Michigan",53,26,163,506700,0,53,100.0
"Census Tract 5068, Wayne County, Michigan",758,26,163,506800,0,758,100.0
"Census Tract 5069, Wayne County, Michigan",556,26,163,506900,11,545,98.02158273381295
"Census Tract 5070, Wayne County, Michigan",520,26,163,507000,13,507,97.5
"Census Tract 5071, Wayne County, Michigan",341,26,163,507100,0,341,100.0
"Census Tract 5072, Wayne County, Michigan",178,26,163,507200,9,169,94.9438202247191
"Census Tract 5073, Wayne County, Michigan",272,26,163,507300,0,272,100.0
"Census Tract 5074, Wayne County, Michigan",465,26,163,507400,0,465,100.0
"Census Tract 5075, Wayne County, Michigan",471,26,163,507500,6,465,98.72611464968153
"Census Tract 5078, Wayne County, Michigan",76,26,163,507800,0,76,100.0
"Census Tract 5079, Wayne County, Michigan",179,26,163,507900,0,179,100.0
"Census Tract 5080, Wayne County, Michigan",609,26,163,508000,21,588,96.55172413793103
"Census Tract 5081, Wayne County, Michigan",170,26,163,508100,0,170,100.0
"Census Tract 5104, Wayne County, Michigan",91,26,163,510400,0,91,100.0
"Census Tract 5105, Wayne County, Michigan",450,26,163,510500,115,335,74.44444444444444
"Census Tract 5106, Wayne County, Michigan",515,26,163,510600,129,386,74.9514563106796
"Census Tract 5107, Wayne County, Michigan",343,26,163,510700,186,157,45.77259475218659
"Census Tract 5110, Wayne County, Michigan",359,26,163,511000,18,341,94.98607242339833
"Census Tract 5112, Wayne County, Michigan",311,26,163,511200,15,296,95.17684887459808
"Census Tract 5113, Wayne County, Michigan",230,26,163,511300,72,158,68.69565217391305
"Census Tract 5114, Wayne County, Michigan",684,26,163,511400,34,650,95.02923976608187
"Census Tract 5119, Wayne County, Michigan",532,26,163,511900,134,398,74.81203007518798
"Census Tract 5121, Wayne County, Michigan",298,26,163,512100,8,290,97.31543624161074
"Census Tract 5122, Wayne County, Michigan",333,26,163,512200,0,333,100.0
"Census Tract 5123, Wayne County, Michigan",441,26,163,512300,0,441,100.0
"Census Tract 5124, Wayne County, Michigan",222,26,163,512400,0,222,100.0
"Census Tract 5126, Wayne County, Michigan",256,26,163,512600,0,256,100.0
"Census Tract 5129, Wayne County, Michigan",334,26,163,512900,56,278,83.23353293413174
"Census Tract 5132, Wayne County, Michigan",359,26,163,513200,79,280,77.99442896935933
"Census Tract 5133, Wayne County, Michigan",549,26,163,513300,134,415,75.591985428051
"Census Tract 5136, Wayne County, Michigan",309,26,163,513600,0,309,100.0
"Census Tract 5137, Wayne County, Michigan",779,26,163,513700,10,769,98.71630295250321
"Census Tract 5139, Wayne County, Michigan",295,26,163,513900,0,295,100.0
"Census Tract 5141, Wayne County, Michigan",411,26,163,514100,14,397,96.59367396593674
"Census Tract 5142, Wayne County, Michigan",507,26,163,514200,0,507,100.0
"Census Tract 5143, Wayne County, Michigan",628,26,163,514300,9,619,98.56687898089172
"Census Tract 5145, Wayne County, Michigan",231,26,163,514500,0,231,100.0
"Census Tract 5152, Wayne County, Michigan",304,26,163,515200,6,298,98.02631578947368
"Census Tract 5153, Wayne County, Michigan",1535,26,163,515300,298,1237,80.58631921824104
"Census Tract 5154, Wayne County, Michigan",339,26,163,515400,173,166,48.96755162241888
"Census Tract 5156, Wayne County, Michigan",442,26,163,515600,46,396,89.59276018099548
"Census Tract 5157, Wayne County, Michigan",1884,26,163,515700,467,1417,75.21231422505308
"Census Tract 5159, Wayne County, Michigan",151,26,163,515900,0,151,100.0
"Census Tract 5160, Wayne County, Michigan",320,26,163,516000,35,285,89.0625
"Census Tract 5161, Wayne County, Michigan",135,26,163,516100,3,132,97.77777777777777
"Census Tract 5162, Wayne County, Michigan",159,26,163,516200,17,142,89.30817610062893
"Census Tract 5163, Wayne County, Michigan",102,26,163,516300,0,102,100.0
"Census Tract 5164, Wayne County, Michigan",171,26,163,516400,62,109,63.74269005847953
"Census Tract 5165, Wayne County, Michigan",1037,26,163,516500,381,656,63.25940212150434
"Census Tract 5166, Wayne County, Michigan",906,26,163,516600,35,871,96.13686534216336
"Census Tract 5167, Wayne County, Michigan",1539,26,163,516700,53,1486,96.55620532813515
"Census Tract 5168, Wayne County, Michigan",131,26,163,516800,38,93,70.99236641221374
"Census Tract 5169, Wayne County, Michigan",1050,26,163,516900,38,1012,96.38095238095238
"Census Tract 5170, Wayne County, Michigan",1859,26,163,517000,799,1060,57.019903173749334
"Census Tract 5171, Wayne County, Michigan",542,26,163,517100,127,415,76.56826568265683
"Census Tract 5172, Wayne County, Michigan",933,26,163,517200,536,397,42.55091103965702
"Census Tract 5173, Wayne County, Michigan",983,26,163,517300,250,733,74.5676500508647
"Census Tract 5175, Wayne County, Michigan",1700,26,163,517500,264,1436,84.47058823529412
"Census Tract 5180, Wayne County, Michigan",1050,26,163,518000,215,835,79.52380952380952
"Census Tract 5184, Wayne County, Michigan",68,26,163,518400,15,53,77.94117647058823
"Census Tract 5185, Wayne County, Michigan",201,26,163,518500,62,139,69.15422885572139
"Census Tract 5186, Wayne County, Michigan",128,26,163,518600,8,120,93.75
"Census Tract 5188, Wayne County, Michigan",136,26,163,518800,32,104,76.47058823529412
"Census Tract 5189, Wayne County, Michigan",823,26,163,518900,14,809,98.29890643985419
"Census Tract 5202, Wayne County, Michigan",924,26,163,520200,552,372,40.25974025974026
"Census Tract 5203, Wayne County, Michigan",1046,26,163,520300,419,627,59.94263862332696
"Census Tract 5204, Wayne County, Michigan",906,26,163,520400,338,568,62.69315673289183
"Census Tract 5207, Wayne County, Michigan",2032,26,163,520700,1139,893,43.946850393700785
"Census Tract 5208, Wayne County, Michigan",844,26,163,520800,197,647,76.65876777251185
"Census Tract 5211, Wayne County, Michigan",447,26,163,521100,107,340,76.0626398210291
"Census Tract 5213, Wayne County, Michigan",54,26,163,521300,7,47,87.03703703703704
"Census Tract 5214, Wayne County, Michigan",315,26,163,521400,114,201,63.8095238095238
"Census Tract 5215, Wayne County, Michigan",553,26,163,521500,125,428,77.39602169981917
"Census Tract 5218, Wayne County, Michigan",897,26,163,521800,20,877,97.77034559643255
"Census Tract 5219, Wayne County, Michigan",996,26,163,521900,191,805,80.82329317269075
"Census Tract 5220, Wayne County, Michigan",776,26,163,522000,5,771,99.35567010309279
"Census Tract 5221, Wayne County, Michigan",70,26,163,522100,0,70,100.0
"Census Tract 5222, Wayne County, Michigan",73,26,163,522200,0,73,100.0
"Census Tract 5223, Wayne County, Michigan",573,26,163,522300,13,560,97.73123909249564
"Census Tract 5224, Wayne County, Michigan",453,26,163,522400,37,416,91.83222958057395
"Census Tract 5225, Wayne County, Michigan",813,26,163,522500,99,714,87.82287822878229
"Census Tract 5231, Wayne County, Michigan",354,26,163,523100,85,269,75.98870056497175
"Census Tract 5232, Wayne County, Michigan",507,26,163,523200,133,374,73.76725838264299
"Census Tract 5233, Wayne County, Michigan",465,26,163,523300,114,351,75.48387096774194
"Census Tract 5234, Wayne County, Michigan",586,26,163,523400,130,456,77.81569965870307
"Census Tract 5238, Wayne County, Michigan",636,26,163,523800,133,503,79.0880503144654
"Census Tract 5240, Wayne County, Michigan",636,26,163,524000,137,499,78.45911949685535
"Census Tract 5241, Wayne County, Michigan",931,26,163,524100,185,746,80.12889366272825
"Census Tract 5242, Wayne County, Michigan",593,26,163,524200,139,454,76.55986509274874
"Census Tract 5243, Wayne County, Michigan",396,26,163,524300,61,335,84.59595959595958
"Census Tract 5245, Wayne County, Michigan",25,26,163,524500,7,18,72.0
"Census Tract 5247, Wayne County, Michigan",743,26,163,524700,13,730,98.25033647375506
"Census Tract 5248, Wayne County, Michigan",388,26,163,524800,44,344,88.65979381443299
"Census Tract 5249, Wayne County, Michigan",99,26,163,524900,29,70,70.70707070707071
"Census Tract 5250, Wayne County, Michigan",219,26,163,525000,55,164,74.88584474885845
"Census Tract 5254, Wayne County, Michigan",491,26,163,525400,76,415,84.5213849287169
"Census Tract 5255, Wayne County, Michigan",93,26,163,525500,33,60,64.51612903225806
"Census Tract 5256, Wayne County, Michigan",150,26,163,525600,30,120,80.0
"Census Tract 5257, Wayne County, Michigan",806,26,163,525700,164,642,79.65260545905707
"Census Tract 5258, Wayne County, Michigan",411,26,163,525800,105,306,74.45255474452554
"Census Tract 5260, Wayne County, Michigan",302,26,163,526000,170,132,43.70860927152318
"Census Tract 5261, Wayne County, Michigan",294,26,163,526100,179,115,39.1156462585034
"Census Tract 5262, Wayne County, Michigan",341,26,163,526200,91,250,73.31378299120234
"Census Tract 5263, Wayne County, Michigan",611,26,163,526300,108,503,82.3240589198036
"Census Tract 5264, Wayne County, Michigan",151,26,163,526400,0,151,100.0
"Census Tract 5265, Wayne County, Michigan",289,26,163,526500,0,289,100.0
"Census Tract 5272, Wayne County, Michigan",130,26,163,527200,0,130,100.0
"Census Tract 5273, Wayne County, Michigan",103,26,163,527300,0,103,100.0
"Census Tract 5301, Wayne County, Michigan",668,26,163,530100,0,668,100.0
"Census Tract 5302, Wayne County, Michigan",659,26,163,530200,0,659,100.0
"Census Tract 5303, Wayne County, Michigan",132,26,163,530300,0,132,100.0
"Census Tract 5304, Wayne County, Michigan",315,26,163,530400,31,284,90.15873015873017
"Census Tract 5305, Wayne County, Michigan",239,26,163,530500,14,225,94.14225941422593
"Census Tract 5308, Wayne County, Michigan",320,26,163,530800,9,311,97.1875
"Census Tract 5309, Wayne County, Michigan",443,26,163,530900,0,443,100.0
"Census Tract 5311, Wayne County, Michigan",426,26,163,531100,8,418,98.12206572769952
"Census Tract 5312, Wayne County, Michigan",115,26,163,531200,17,98,85.21739130434783
"Census Tract 5313, Wayne County, Michigan",359,26,163,531300,26,333,92.75766016713092
"Census Tract 5314, Wayne County, Michigan",203,26,163,531400,11,192,94.58128078817734
"Census Tract 5315, Wayne County, Michigan",578,26,163,531500,0,578,100.0
"Census Tract 5316, Wayne County, Michigan",456,26,163,531600,7,449,98.46491228070175
"Census Tract 5317, Wayne County, Michigan",586,26,163,531700,0,586,100.0
"Census Tract 5318, Wayne County, Michigan",379,26,163,531800,7,372,98.15303430079155
"Census Tract 5319, Wayne County, Michigan",203,26,163,531900,22,181,89.16256157635468
"Census Tract 5322, Wayne County, Michigan",209,26,163,532200,16,193,92.34449760765551
"Census Tract 5323, Wayne County, Michigan",110,26,163,532300,36,74,67.27272727272727
"Census Tract 5324, Wayne County, Michigan",428,26,163,532400,32,396,92.5233644859813
"Census Tract 5326, Wayne County, Michigan",910,26,163,532600,72,838,92.08791208791209
"Census Tract 5327, Wayne County, Michigan",146,26,163,532700,0,146,100.0
"Census Tract 5330, Wayne County, Michigan",326,26,163,533000,14,312,95.70552147239265
"Census Tract 5331, Wayne County, Michigan",518,26,163,533100,8,510,98.45559845559846
"Census Tract 5332, Wayne County, Michigan",117,26,163,533200,10,107,91.45299145299145
"Census Tract 5333, Wayne County, Michigan",157,26,163,533300,0,157,100.0
"Census Tract 5334, Wayne County, Michigan",439,26,163,533400,0,439,100.0
"Census Tract 5335, Wayne County, Michigan",226,26,163,533500,0,226,100.0
"Census Tract 5336, Wayne County, Michigan",298,26,163,533600,0,298,100.0
"Census Tract 5337, Wayne County, Michigan",239,26,163,533700,3,236,98.74476987447699
"Census Tract 5339, Wayne County, Michigan",1641,26,163,533900,347,1294,78.85435709932968
"Census Tract 5341, Wayne County, Michigan",531,26,163,534100,27,504,94.91525423728814
"Census Tract 5342, Wayne County, Michigan",458,26,163,534200,0,458,100.0
"Census Tract 5343, Wayne County, Michigan",198,26,163,534300,0,198,100.0
"Census Tract 5344, Wayne County, Michigan",341,26,163,534400,15,326,95.60117302052787
"Census Tract 5345, Wayne County, Michigan",136,26,163,534500,0,136,100.0
"Census Tract 5346, Wayne County, Michigan",283,26,163,534600,0,283,100.0
"Census Tract 5347, Wayne County, Michigan",515,26,163,534700,0,515,100.0
"Census Tract 5350, Wayne County, Michigan",427,26,163,535000,0,427,100.0
"Census Tract 5351, Wayne County, Michigan",322,26,163,535100,0,322,100.0
"Census Tract 5352, Wayne County, Michigan",373,26,163,535200,15,358,95.97855227882037
"Census Tract 5353, Wayne County, Michigan",673,26,163,535300,23,650,96.58246656760772
"Census Tract 5354, Wayne County, Michigan",319,26,163,535400,7,312,97.80564263322884
"Census Tract 5355, Wayne County, Michigan",690,26,163,535500,57,633,91.73913043478261
"Census Tract 5356, Wayne County, Michigan",524,26,163,535600,0,524,100.0
"Census Tract 5357, Wayne County, Michigan",244,26,163,535700,0,244,100.0
"Census Tract 5361, Wayne County, Michigan",606,26,163,536100,0,606,100.0
"Census Tract 5362, Wayne County, Michigan",343,26,163,536200,6,337,98.25072886297376
"Census Tract 5363, Wayne County, Michigan",330,26,163,536300,0,330,100.0
"Census Tract 5364, Wayne County, Michigan",304,26,163,536400,18,286,94.07894736842105
"Census Tract 5365, Wayne County, Michigan",496,26,163,536500,26,470,94.75806451612904
"Census Tract 5366, Wayne County, Michigan",360,26,163,536600,0,360,100.0
"Census Tract 5367, Wayne County, Michigan",233,26,163,536700,0,233,100.0
"Census Tract 5368, Wayne County, Michigan",349,26,163,536800,0,349,100.0
"Census Tract 5369, Wayne County, Michigan",524,26,163,536900,0,524,100.0
"Census Tract 5370, Wayne County, Michigan",463,26,163,537000,0,463,100.0
"Census Tract 5371, Wayne County, Michigan",464,26,163,537100,16,448,96.55172413793103
"Census Tract 5372, Wayne County, Michigan",150,26,163,537200,3,147,98.0
"Census Tract 5373, Wayne County, Michigan",372,26,163,537300,0,372,100.0
"Census Tract 5375, Wayne County, Michigan",321,26,163,537500,0,321,100.0
"Census Tract 5376, Wayne County, Michigan",520,26,163,537600,27,493,94.8076923076923
"Census Tract 5377, Wayne County, Michigan",697,26,163,537700,0,697,100.0
"Census Tract 5378, Wayne County, Michigan",252,26,163,537800,0,252,100.0
"Census Tract 5381, Wayne County, Michigan",254,26,163,538100,64,190,74.80314960629921
"Census Tract 5382, Wayne County, Michigan",65,26,163,538200,0,65,100.0
"Census Tract 5383, Wayne County, Michigan",1043,26,163,538300,146,897,86.0019175455417
"Census Tract 5384, Wayne County, Michigan",233,26,163,538400,12,221,94.84978540772532
"Census Tract 5385, Wayne County, Michigan",742,26,163,538500,69,673,90.70080862533693
"Census Tract 5386, Wayne County, Michigan",654,26,163,538600,15,639,97.70642201834863
"Census Tract 5387, Wayne County, Michigan",748,26,163,538700,12,736,98.3957219251337
"Census Tract 5388, Wayne County, Michigan",279,26,163,538800,0,279,100.0
"Census Tract 5389, Wayne County, Michigan",680,26,163,538900,0,680,100.0
"Census Tract 5390, Wayne County, Michigan",380,26,163,539000,17,363,95.52631578947368
"Census Tract 5391, Wayne County, Michigan",317,26,163,539100,8,309,97.47634069400631
"Census Tract 5392, Wayne County, Michigan",665,26,163,539200,0,665,100.0
"Census Tract 5393, Wayne County, Michigan",417,26,163,539300,0,417,100.0
"Census Tract 5394, Wayne County, Michigan",652,26,163,539400,17,635,97.39263803680981
"Census Tract 5395, Wayne County, Michigan",596,26,163,539500,0,596,100.0
"Census Tract 5396, Wayne County, Michigan",436,26,163,539600,0,436,100.0
"Census Tract 5397, Wayne County, Michigan",457,26,163,539700,0,457,100.0
"Census Tract 5401, Wayne County, Michigan",451,26,163,540100,48,403,89.3569844789357
"Census Tract 5402, Wayne County, Michigan",530,26,163,540200,0,530,100.0
"Census Tract 5403, Wayne County, Michigan",846,26,163,540300,0,846,100.0
"Census Tract 5404, Wayne County, Michigan",708,26,163,540400,14,694,98.0225988700565
"Census Tract 5405, Wayne County, Michigan",516,26,163,540500,0,516,100.0
"Census Tract 5406, Wayne County, Michigan",516,26,163,540600,0,516,100.0
"Census Tract 5407, Wayne County, Michigan",555,26,163,540700,17,538,96.93693693693693
"Census Tract 5408, Wayne County, Michigan",414,26,163,540800,0,414,100.0
"Census Tract 5409, Wayne County, Michigan",570,26,163,540900,0,570,100.0
"Census Tract 5410, Wayne County, Michigan",1086,26,163,541000,79,1007,92.72559852670351
"Census Tract 5411, Wayne County, Michigan",384,26,163,541100,28,356,92.70833333333334
"Census Tract 5412, Wayne County, Michigan",709,26,163,541200,0,709,100.0
"Census Tract 5413, Wayne County, Michigan",466,26,163,541300,34,432,92.7038626609442
"Census Tract 5414, Wayne County, Michigan",426,26,163,541400,26,400,93.89671361502347
"Census Tract 5415, Wayne County, Michigan",824,26,163,541500,24,800,97.0873786407767
"Census Tract 5417, Wayne County, Michigan",1162,26,163,541700,51,1111,95.61101549053356
"Census Tract 5418, Wayne County, Michigan",447,26,163,541800,20,427,95.52572706935123
"Census Tract 5421, Wayne County, Michigan",746,26,163,542100,18,728,97.58713136729223
"Census Tract 5422, Wayne County, Michigan",608,26,163,542200,0,608,100.0
"Census Tract 5423, Wayne County, Michigan",458,26,163,542300,0,458,100.0
"Census Tract 5424, Wayne County, Michigan",546,26,163,542400,7,539,98.71794871794873
"Census Tract 5425, Wayne County, Michigan",336,26,163,542500,0,336,100.0
"Census Tract 5426, Wayne County, Michigan",788,26,163,542600,0,788,100.0
"Census Tract 5427, Wayne County, Michigan",140,26,163,542700,0,140,100.0
"Census Tract 5428, Wayne County, Michigan",249,26,163,542800,28,221,88.75502008032129
"Census Tract 5429, Wayne County, Michigan",214,26,163,542900,9,205,95.7943925233645
"Census Tract 5430, Wayne County, Michigan",104,26,163,543000,23,81,77.88461538461539
"Census Tract 5431, Wayne County, Michigan",208,26,163,543100,24,184,88.46153846153845
"Census Tract 5432, Wayne County, Michigan",365,26,163,543200,0,365,100.0
"Census Tract 5434, Wayne County, Michigan",381,26,163,543400,46,335,87.92650918635171
"Census Tract 5435, Wayne County, Michigan",134,26,163,543500,42,92,68.65671641791045
"Census Tract 5436, Wayne County, Michigan",195,26,163,543600,28,167,85.64102564102564
"Census Tract 5437, Wayne County, Michigan",629,26,163,543700,0,629,100.0
"Census Tract 5438, Wayne County, Michigan",267,26,163,543800,36,231,86.51685393258427
"Census Tract 5439, Wayne County, Michigan",301,26,163,543900,19,282,93.68770764119601
"Census Tract 5440, Wayne County, Michigan",714,26,163,544000,27,687,96.21848739495799
"Census Tract 5441, Wayne County, Michigan",698,26,163,544100,23,675,96.70487106017191
"Census Tract 5442, Wayne County, Michigan",476,26,163,544200,23,453,95.16806722689076
"Census Tract 5443, Wayne County, Michigan",623,26,163,544300,120,503,80.73836276083468
"Census Tract 5451, Wayne County, Michigan",163,26,163,545100,0,163,100.0
"Census Tract 5452, Wayne County, Michigan",508,26,163,545200,0,508,100.0
"Census Tract 5453, Wayne County, Michigan",464,26,163,545300,29,435,93.75
"Census Tract 5454, Wayne County, Michigan",701,26,163,545400,0,701,100.0
"Census Tract 5455, Wayne County, Michigan",850,26,163,545500,119,731,86.0
"Census Tract 5456, Wayne County, Michigan",677,26,163,545600,428,249,36.779911373707534
"Census Tract 5457, Wayne County, Michigan",485,26,163,545700,183,302,62.2680412371134
"Census Tract 5458, Wayne County, Michigan",1011,26,163,545800,243,768,75.96439169139467
"Census Tract 5459, Wayne County, Michigan",687,26,163,545900,96,591,86.02620087336244
"Census Tract 5460, Wayne County, Michigan",544,26,163,546000,26,518,95.22058823529412
"Census Tract 5461, Wayne County, Michigan",709,26,163,546100,61,648,91.3963328631876
"Census Tract 5462, Wayne County, Michigan",441,26,163,546200,69,372,84.35374149659864
"Census Tract 5463, Wayne County, Michigan",220,26,163,546300,0,220,100.0
"Census Tract 5464, Wayne County, Michigan",183,26,163,546400,0,183,100.0
"Census Tract 5465, Wayne County, Michigan",664,26,163,546500,10,654,98.49397590361446
"Census Tract 5466, Wayne County, Michigan",397,26,163,546600,21,376,94.7103274559194
"Census Tract 5467, Wayne County, Michigan",468,26,163,546700,33,435,92.94871794871796
"Census Tract 5468, Wayne County, Michigan",604,26,163,546800,12,592,98.01324503311258
"Census Tract 5469, Wayne County, Michigan",240,26,163,546900,0,240,100.0
"Census Tract 5501, Wayne County, Michigan",452,26,163,550100,332,120,26.548672566371685
"Census Tract 5501.01, Grand Traverse County, Michigan",491,26,55,550101,360,131,26.680244399185337
"Census Tract 5501.02, Grand Traverse County, Michigan",279,26,55,550102,268,11,3.942652329749104
"Census Tract 5502, Wayne County, Michigan",655,26,163,550200,429,226,34.50381679389313
"Census Tract 5502, Grand Traverse County, Michigan",168,26,55,550200,168,0,0.0
"Census Tract 5503, Grand Traverse County, Michigan",182,26,55,550300,158,24,13.186813186813188
"Census Tract 5503, Wayne County, Michigan",44,26,163,550300,44,0,0.0
"Census Tract 5504, Grand Traverse County, Michigan",178,26,55,550400,178,0,0.0
"Census Tract 5504, Wayne County, Michigan",225,26,163,550400,180,45,20.0
"Census Tract 5505, Wayne County, Michigan",189,26,163,550500,148,41,21.693121693121693
"Census Tract 5505, Grand Traverse County, Michigan",480,26,55,550500,381,99,20.625
"Census Tract 5506, Wayne County, Michigan",16,26,163,550600,16,0,0.0
"Census Tract 5506, Grand Traverse County, Michigan",503,26,55,550600,497,6,1.1928429423459244
"Census Tract 5507, Wayne County, Michigan",163,26,163,550700,124,39,23.92638036809816
"Census Tract 5507, Grand Traverse County, Michigan",931,26,55,550700,931,0,0.0
"Census Tract 5508, Wayne County, Michigan",47,26,163,550800,47,0,0.0
"Census Tract 5508, Grand Traverse County, Michigan",115,26,55,550800,115,0,0.0
"Census Tract 5509, Wayne County, Michigan",72,26,163,550900,52,20,27.77777777777778
"Census Tract 5509, Grand Traverse County, Michigan",307,26,55,550900,289,18,5.863192182410423
"Census Tract 5510, Grand Traverse County, Michigan",487,26,55,551000,454,33,6.7761806981519515
"Census Tract 5511, Grand Traverse County, Michigan",355,26,55,551100,259,96,27.042253521126757
"Census Tract 5511, Wayne County, Michigan",73,26,163,551100,61,12,16.43835616438356
"Census Tract 5512, Grand Traverse County, Michigan",832,26,55,551200,749,83,9.975961538461538
"Census Tract 5512, Wayne County, Michigan",195,26,163,551200,167,28,14.358974358974358
"Census Tract 5513, Wayne County, Michigan",605,26,163,551300,234,371,61.32231404958678
"Census Tract 5513, Grand Traverse County, Michigan",2170,26,55,551300,1980,190,8.755760368663594
"Census Tract 5514, Grand Traverse County, Michigan",969,26,55,551400,823,146,15.067079463364294
"Census Tract 5514, Wayne County, Michigan",632,26,163,551400,127,505,79.90506329113924
"Census Tract 5515, Grand Traverse County, Michigan",392,26,55,551500,381,11,2.806122448979592
"Census Tract 5515, Wayne County, Michigan",227,26,163,551500,40,187,82.37885462555066
"Census Tract 5516, Wayne County, Michigan",801,26,163,551600,69,732,91.38576779026218
"Census Tract 5517, Wayne County, Michigan",10,26,163,551700,10,0,0.0
"Census Tract 5518, Wayne County, Michigan",294,26,163,551800,227,67,22.789115646258505
"Census Tract 5520, Wayne County, Michigan",288,26,163,552000,120,168,58.333333333333336
"Census Tract 5521, Wayne County, Michigan",697,26,163,552100,244,453,64.99282639885222
"Census Tract 5522, Wayne County, Michigan",345,26,163,552200,260,85,24.637681159420293
"Census Tract 5523, Wayne County, Michigan",572,26,163,552300,390,182,31.818181818181817
"Census Tract 5524, Wayne County, Michigan",292,26,163,552400,107,185,63.35616438356164
"Census Tract 5528, Wayne County, Michigan",658,26,163,552800,429,229,34.80243161094225
"Census Tract 5530, Wayne County, Michigan",382,26,163,553000,17,365,95.54973821989529
"Census Tract 5531, Wayne County, Michigan",227,26,163,553100,17,210,92.51101321585902
"Census Tract 5532, Wayne County, Michigan",155,26,163,553200,18,137,88.38709677419355
"Census Tract 5533, Wayne County, Michigan",418,26,163,553300,7,411,98.32535885167464
"Census Tract 5534, Wayne County, Michigan",1297,26,163,553400,0,1297,100.0
"Census Tract 5536, Wayne County, Michigan",250,26,163,553600,36,214,85.6
"Census Tract 5538, Wayne County, Michigan",161,26,163,553800,14,147,91.30434782608695
"Census Tract 5541, Wayne County, Michigan",529,26,163,554100,120,409,77.31568998109641
"Census Tract 5542, Wayne County, Michigan",335,26,163,554200,164,171,51.04477611940299
"Census Tract 5543, Wayne County, Michigan",511,26,163,554300,250,261,51.07632093933464
"Census Tract 5544, Wayne County, Michigan",397,26,163,554400,134,263,66.24685138539043
"Census Tract 5545, Wayne County, Michigan",445,26,163,554500,162,283,63.59550561797753
"Census Tract 5546, Wayne County, Michigan",299,26,163,554600,156,143,47.82608695652174
"Census Tract 5547, Wayne County, Michigan",190,26,163,554700,108,82,43.15789473684211
"Census Tract 5548, Wayne County, Michigan",311,26,163,554800,105,206,66.2379421221865
"Census Tract 5549, Wayne County, Michigan",213,26,163,554900,48,165,77.46478873239437
"Census Tract 5551, Wayne County, Michigan",485,26,163,555100,219,266,54.84536082474227
"Census Tract 5553, Wayne County, Michigan",400,26,163,555300,187,213,53.25
"Census Tract 5554, Wayne County, Michigan",173,26,163,555400,0,173,100.0
"Census Tract 5555, Wayne County, Michigan",378,26,163,555500,29,349,92.32804232804233
"Census Tract 5556, Wayne County, Michigan",123,26,163,555600,47,76,61.78861788617886
"Census Tract 5561, Wayne County, Michigan",290,26,163,556100,244,46,15.862068965517242
"Census Tract 5562, Wayne County, Michigan",609,26,163,556200,465,144,23.645320197044335
"Census Tract 5563, Wayne County, Michigan",405,26,163,556300,293,112,27.65432098765432
"Census Tract 5564, Wayne County, Michigan",223,26,163,556400,177,46,20.62780269058296
"Census Tract 5565, Wayne County, Michigan",308,26,163,556500,237,71,23.051948051948052
"Census Tract 5566, Wayne County, Michigan",4,26,163,556600,0,4,100.0
"Census Tract 5567, Wayne County, Michigan",93,26,163,556700,86,7,7.526881720430108
"Census Tract 5568, Wayne County, Michigan",21,26,163,556800,20,1,4.761904761904762
"Census Tract 5569, Wayne County, Michigan",144,26,163,556900,136,8,5.555555555555555
"Census Tract 5570, Wayne County, Michigan",355,26,163,557000,147,208,58.59154929577465
"Census Tract 5571, Wayne County, Michigan",172,26,163,557100,122,50,29.069767441860467
"Census Tract 5572, Wayne County, Michigan",150,26,163,557200,144,6,4.0
"Census Tract 5573, Wayne County, Michigan",54,26,163,557300,48,6,11.11111111111111
"Census Tract 5574, Wayne County, Michigan",59,26,163,557400,59,0,0.0
"Census Tract 5575, Wayne County, Michigan",31,26,163,557500,31,0,0.0
"Census Tract 5576, Wayne County, Michigan",0,26,163,557600,0,0,
"Census Tract 5577, Wayne County, Michigan",52,26,163,557700,36,16,30.76923076923077
"Census Tract 5579, Wayne County, Michigan",241,26,163,557900,213,28,11.618257261410788
"Census Tract 5580, Wayne County, Michigan",133,26,163,558000,119,14,10.526315789473683
"Census Tract 5581, Wayne County, Michigan",152,26,163,558100,145,7,4.605263157894736
"Census Tract 5582, Wayne County, Michigan",264,26,163,558200,121,143,54.166666666666664
"Census Tract 5583, Wayne County, Michigan",215,26,163,558300,174,41,19.069767441860467
"Census Tract 5584, Wayne County, Michigan",341,26,163,558400,304,37,10.850439882697946
"Census Tract 5585, Wayne County, Michigan",169,26,163,558500,142,27,15.976331360946746
"Census Tract 5586, Wayne County, Michigan",94,26,163,558600,70,24,25.53191489361702
"Census Tract 5587, Wayne County, Michigan",83,26,163,558700,83,0,0.0
"Census Tract 5588, Wayne County, Michigan",119,26,163,558800,111,8,6.722689075630252
"Census Tract 5589, Wayne County, Michigan",46,26,163,558900,43,3,6.521739130434782
"Census Tract 5590, Wayne County, Michigan",181,26,163,559000,126,55,30.386740331491712
"Census Tract 5591, Wayne County, Michigan",112,26,163,559100,104,8,7.142857142857142
"Census Tract 5592, Wayne County, Michigan",91,26,163,559200,65,26,28.57142857142857
"Census Tract 5601, Wayne County, Michigan",266,26,163,560100,247,19,7.142857142857142
"Census Tract 5602, Wayne County, Michigan",1193,26,163,560200,863,330,27.661357921207042
"Census Tract 5603, Wayne County, Michigan",362,26,163,560300,244,118,32.59668508287293
"Census Tract 5604, Wayne County, Michigan",610,26,163,560400,545,65,10.655737704918032
"Census Tract 5612, Wayne County, Michigan",111,26,163,561200,86,25,22.52252252252252
"Census Tract 5613, Wayne County, Michigan",78,26,163,561300,44,34,43.58974358974359
"Census Tract 5616, Wayne County, Michigan",620,26,163,561600,591,29,4.67741935483871
"Census Tract 5617, Wayne County, Michigan",107,26,163,561700,102,5,4.672897196261682
"Census Tract 5619, Wayne County, Michigan",70,26,163,561900,70,0,0.0
"Census Tract 5623, Wayne County, Michigan",140,26,163,562300,65,75,53.57142857142857
"Census Tract 5624, Wayne County, Michigan",147,26,163,562400,147,0,0.0
"Census Tract 5625, Wayne County, Michigan",649,26,163,562500,581,68,10.477657935285054
"Census Tract 5626, Wayne County, Michigan",461,26,163,562600,450,11,2.386117136659436
"Census Tract 5627, Wayne County, Michigan",496,26,163,562700,478,18,3.6290322580645165
"Census Tract 5628, Wayne County, Michigan",452,26,163,562800,355,97,21.460176991150444
"Census Tract 5629, Wayne County, Michigan",428,26,163,562900,385,43,10.046728971962617
"Census Tract 5632, Wayne County, Michigan",674,26,163,563200,242,432,64.09495548961425
"Census Tract 5633, Wayne County, Michigan",709,26,163,563300,459,250,35.26093088857546
"Census Tract 5634, Wayne County, Michigan",340,26,163,563400,233,107,31.470588235294116
"Census Tract 5635, Wayne County, Michigan",0,26,163,563500,0,0,
"Census Tract 5636, Wayne County, Michigan",84,26,163,563600,62,22,26.190476190476193
"Census Tract 5637, Wayne County, Michigan",168,26,163,563700,69,99,58.92857142857143
"Census Tract 5638, Wayne County, Michigan",273,26,163,563800,130,143,52.38095238095239
"Census Tract 5639, Wayne County, Michigan",193,26,163,563900,112,81,41.968911917098445
"Census Tract 5640, Wayne County, Michigan",729,26,163,564000,310,419,57.475994513031544
"Census Tract 5641, Wayne County, Michigan",998,26,163,564100,337,661,66.23246492985973
"Census Tract 5642, Wayne County, Michigan",434,26,163,564200,346,88,20.276497695852534
"Census Tract 5643, Wayne County, Michigan",225,26,163,564300,157,68,30.22222222222222
"Census Tract 5644.01, Wayne County, Michigan",8,26,163,564401,8,0,0.0
"Census Tract 5644.02, Wayne County, Michigan",436,26,163,564402,268,168,38.53211009174312
"Census Tract 5645.01, Wayne County, Michigan",79,26,163,564501,42,37,46.835443037974684
"Census Tract 5645.02, Wayne County, Michigan",71,26,163,564502,47,24,33.80281690140845
"Census Tract 5645.03, Wayne County, Michigan",287,26,163,564503,101,186,64.80836236933798
"Census Tract 5645.04, Wayne County, Michigan",359,26,163,564504,166,193,53.760445682451255
"Census Tract 5646, Wayne County, Michigan",232,26,163,564600,167,65,28.01724137931034
"Census Tract 5647, Wayne County, Michigan",832,26,163,564700,341,491,59.01442307692307
"Census Tract 5648, Wayne County, Michigan",185,26,163,564800,116,69,37.2972972972973
"Census Tract 5649, Wayne County, Michigan",264,26,163,564900,166,98,37.121212121212125
"Census Tract 5650, Wayne County, Michigan",428,26,163,565000,172,256,59.813084112149525
"Census Tract 5651, Wayne County, Michigan",488,26,163,565100,250,238,48.77049180327869
"Census Tract 5652, Wayne County, Michigan",1293,26,163,565200,597,696,53.82830626450116
"Census Tract 5653, Wayne County, Michigan",2279,26,163,565300,1127,1152,50.54848617814831
"Census Tract 5656, Wayne County, Michigan",56,26,163,565600,53,3,5.357142857142857
"Census Tract 5657, Wayne County, Michigan",110,26,163,565700,75,35,31.818181818181817
"Census Tract 5658, Wayne County, Michigan",619,26,163,565800,510,109,17.60904684975767
"Census Tract 5659, Wayne County, Michigan",313,26,163,565900,198,115,36.74121405750799
"Census Tract 5664, Wayne County, Michigan",256,26,163,566400,104,152,59.375
"Census Tract 5665, Wayne County, Michigan",743,26,163,566500,369,374,50.33647375504711
"Census Tract 5666, Wayne County, Michigan",164,26,163,566600,131,33,20.121951219512198
"Census Tract 5667, Wayne County, Michigan",434,26,163,566700,378,56,12.903225806451612
"Census Tract 5668, Wayne County, Michigan",415,26,163,566800,251,164,39.51807228915663
"Census Tract 5669, Wayne County, Michigan",713,26,163,566900,347,366,51.332398316970554
"Census Tract 5670, Wayne County, Michigan",462,26,163,567000,102,360,77.92207792207793
"Census Tract 5671, Wayne County, Michigan",516,26,163,567100,335,181,35.077519379844965
"Census Tract 5672.01, Wayne County, Michigan",156,26,163,567201,156,0,0.0
"Census Tract 5672.02, Wayne County, Michigan",608,26,163,567202,332,276,45.39473684210527
"Census Tract 5673, Wayne County, Michigan",466,26,163,567300,249,217,46.56652360515021
"Census Tract 5674, Wayne County, Michigan",256,26,163,567400,209,47,18.359375
"Census Tract 5678, Wayne County, Michigan",1059,26,163,567800,722,337,31.822474032105756
"Census Tract 5679, Wayne County, Michigan",197,26,163,567900,109,88,44.67005076142132
"Census Tract 5680, Wayne County, Michigan",500,26,163,568000,351,149,29.799999999999997
"Census Tract 5682, Wayne County, Michigan",273,26,163,568200,200,73,26.73992673992674
"Census Tract 5683, Wayne County, Michigan",960,26,163,568300,583,377,39.270833333333336
"Census Tract 5684, Wayne County, Michigan",271,26,163,568400,230,41,15.129151291512915
"Census Tract 5685, Wayne County, Michigan",1003,26,163,568500,643,360,35.89232303090728
"Census Tract 5687, Wayne County, Michigan",327,26,163,568700,148,179,54.74006116207951
"Census Tract 5688, Wayne County, Michigan",1699,26,163,568800,744,955,56.209535020600356
"Census Tract 5689, Wayne County, Michigan",180,26,163,568900,171,9,5.0
"Census Tract 5691, Wayne County, Michigan",225,26,163,569100,217,8,3.5555555555555554
"Census Tract 5692, Wayne County, Michigan",378,26,163,569200,272,106,28.04232804232804
"Census Tract 5693, Wayne County, Michigan",341,26,163,569300,301,40,11.730205278592376
"Census Tract 5694, Wayne County, Michigan",224,26,163,569400,140,84,37.5
"Census Tract 5695, Wayne County, Michigan",75,26,163,569500,75,0,0.0
"Census Tract 5696, Wayne County, Michigan",179,26,163,569600,179,0,0.0
"Census Tract 5697, Wayne County, Michigan",317,26,163,569700,272,45,14.195583596214512
"Census Tract 5698, Wayne County, Michigan",232,26,163,569800,156,76,32.758620689655174
"Census Tract 5699, Wayne County, Michigan",105,26,163,569900,98,7,6.666666666666667
"Census Tract 5701, Wayne County, Michigan",1211,26,163,570100,294,917,75.72254335260115
"Census Tract 5702, Wayne County, Michigan",400,26,163,570200,77,323,80.75
"Census Tract 5704, Wayne County, Michigan",999,26,163,570400,257,742,74.27427427427428
"Census Tract 5705, Wayne County, Michigan",666,26,163,570500,91,575,86.33633633633634
"Census Tract 5706, Wayne County, Michigan",443,26,163,570600,47,396,89.39051918735892
"Census Tract 5708, Wayne County, Michigan",691,26,163,570800,70,621,89.86975397973951
"Census Tract 5709, Wayne County, Michigan",259,26,163,570900,19,240,92.66409266409266
"Census Tract 5710, Wayne County, Michigan",445,26,163,571000,41,404,90.78651685393258
"Census Tract 5715, Wayne County, Michigan",473,26,163,571500,195,278,58.7737843551797
"Census Tract 5716, Wayne County, Michigan",264,26,163,571600,161,103,39.015151515151516
"Census Tract 5717, Wayne County, Michigan",349,26,163,571700,105,244,69.91404011461319
"Census Tract 5718, Wayne County, Michigan",241,26,163,571800,129,112,46.47302904564315
"Census Tract 5719, Wayne County, Michigan",444,26,163,571900,312,132,29.72972972972973
"Census Tract 5720, Wayne County, Michigan",130,26,163,572000,118,12,9.230769230769232
"Census Tract 5721, Wayne County, Michigan",461,26,163,572100,342,119,25.813449023861175
"Census Tract 5722, Wayne County, Michigan",363,26,163,572200,142,221,60.88154269972452
"Census Tract 5724, Wayne County, Michigan",135,26,163,572400,116,19,14.074074074074074
"Census Tract 5725, Wayne County, Michigan",208,26,163,572500,140,68,32.69230769230769
"Census Tract 5726, Wayne County, Michigan",620,26,163,572600,476,144,23.225806451612904
"Census Tract 5727, Wayne County, Michigan",331,26,163,572700,260,71,21.45015105740181
"Census Tract 5728, Wayne County, Michigan",597,26,163,572800,527,70,11.725293132328309
"Census Tract 5729, Wayne County, Michigan",222,26,163,572900,222,0,0.0
"Census Tract 5730, Wayne County, Michigan",70,26,163,573000,64,6,8.571428571428571
"Census Tract 5731, Wayne County, Michigan",716,26,163,573100,384,332,46.36871508379888
"Census Tract 5733, Wayne County, Michigan",417,26,163,573300,408,9,2.158273381294964
"Census Tract 5734, Wayne County, Michigan",392,26,163,573400,324,68,17.346938775510203
"Census Tract 5735, Wayne County, Michigan",682,26,163,573500,567,115,16.862170087976537
"Census Tract 5736, Wayne County, Michigan",884,26,163,573600,792,92,10.407239819004525
"Census Tract 5737.01, Wayne County, Michigan",164,26,163,573701,121,43,26.21951219512195
"Census Tract 5737.02, Wayne County, Michigan",564,26,163,573702,554,10,1.773049645390071
"Census Tract 5738, Wayne County, Michigan",523,26,163,573800,451,72,13.766730401529637
"Census Tract 5739, Wayne County, Michigan",467,26,163,573900,459,8,1.7130620985010707
"Census Tract 5740, Wayne County, Michigan",781,26,163,574000,690,91,11.651728553137005
"Census Tract 5741, Wayne County, Michigan",569,26,163,574100,475,94,16.520210896309315
"Census Tract 5742.02, Wayne County, Michigan",678,26,163,574202,360,318,46.902654867256636
"Census Tract 5743, Wayne County, Michigan",451,26,163,574300,293,158,35.033259423503324
"Census Tract 5746, Wayne County, Michigan",243,26,163,574600,211,32,13.168724279835391
"Census Tract 5747, Wayne County, Michigan",195,26,163,574700,186,9,4.615384615384616
"Census Tract 5748, Wayne County, Michigan",64,26,163,574800,52,12,18.75
"Census Tract 5749, Wayne County, Michigan",308,26,163,574900,254,54,17.532467532467532
"Census Tract 5750, Wayne County, Michigan",549,26,163,575000,472,77,14.025500910746814
"Census Tract 5751, Wayne County, Michigan",325,26,163,575100,266,59,18.153846153846153
"Census Tract 5752, Wayne County, Michigan",492,26,163,575200,308,184,37.39837398373984
"Census Tract 5753, Wayne County, Michigan",225,26,163,575300,182,43,19.11111111111111
"Census Tract 5754, Wayne County, Michigan",199,26,163,575400,171,28,14.07035175879397
"Census Tract 5755, Wayne County, Michigan",212,26,163,575500,161,51,24.056603773584907
"Census Tract 5756, Wayne County, Michigan",116,26,163,575600,75,41,35.3448275862069
"Census Tract 5760, Wayne County, Michigan",177,26,163,576000,94,83,46.89265536723164
"Census Tract 5761, Wayne County, Michigan",497,26,163,576100,446,51,10.261569416498995
"Census Tract 5762, Wayne County, Michigan",137,26,163,576200,106,31,22.62773722627737
"Census Tract 5763, Wayne County, Michigan",200,26,163,576300,176,24,12.0
"Census Tract 5764, Wayne County, Michigan",135,26,163,576400,127,8,5.9259259259259265
"Census Tract 5765, Wayne County, Michigan",81,26,163,576500,29,52,64.19753086419753
"Census Tract 5766, Wayne County, Michigan",277,26,163,576600,258,19,6.859205776173286
"Census Tract 5767, Wayne County, Michigan",251,26,163,576700,175,76,30.278884462151396
"Census Tract 5770, Wayne County, Michigan",937,26,163,577000,350,587,62.64674493062967
"Census Tract 5771, Wayne County, Michigan",497,26,163,577100,292,205,41.24748490945674
"Census Tract 5772, Wayne County, Michigan",296,26,163,577200,212,84,28.37837837837838
"Census Tract 5773, Wayne County, Michigan",448,26,163,577300,352,96,21.428571428571427
"Census Tract 5774, Wayne County, Michigan",328,26,163,577400,253,75,22.865853658536587
"Census Tract 5775, Wayne County, Michigan",247,26,163,577500,118,129,52.226720647773284
"Census Tract 5776, Wayne County, Michigan",271,26,163,577600,183,88,32.47232472324723
"Census Tract 5777, Wayne County, Michigan",108,26,163,577700,68,40,37.03703703703704
"Census Tract 5778, Wayne County, Michigan",201,26,163,577800,150,51,25.37313432835821
"Census Tract 5779, Wayne County, Michigan",461,26,163,577900,336,125,27.114967462039047
"Census Tract 5780, Wayne County, Michigan",552,26,163,578000,443,109,19.746376811594203
"Census Tract 5785, Wayne County, Michigan",645,26,163,578500,341,304,47.13178294573643
"Census Tract 5786, Wayne County, Michigan",1179,26,163,578600,613,566,48.00678541136556
"Census Tract 5791, Wayne County, Michigan",368,26,163,579100,174,194,52.71739130434783
"Census Tract 5792, Wayne County, Michigan",435,26,163,579200,154,281,64.59770114942529
"Census Tract 5793, Wayne County, Michigan",574,26,163,579300,12,562,97.90940766550523
"Census Tract 5795, Wayne County, Michigan",316,26,163,579500,173,143,45.25316455696203
"Census Tract 5796, Wayne County, Michigan",281,26,163,579600,37,244,86.83274021352312
"Census Tract 5797, Wayne County, Michigan",511,26,163,579700,282,229,44.81409001956947
"Census Tract 5798, Wayne County, Michigan",416,26,163,579800,177,239,57.45192307692307
"Census Tract 5799, Wayne County, Michigan",794,26,163,579900,413,381,47.984886649874056
"Census Tract 5801, Wayne County, Michigan",311,26,163,580100,268,43,13.826366559485532
"Census Tract 5802, Wayne County, Michigan",279,26,163,580200,191,88,31.54121863799283
"Census Tract 5803, Wayne County, Michigan",237,26,163,580300,214,23,9.70464135021097
"Census Tract 5804, Wayne County, Michigan",113,26,163,580400,113,0,0.0
"Census Tract 5805, Wayne County, Michigan",119,26,163,580500,119,0,0.0
"Census Tract 5806, Wayne County, Michigan",430,26,163,580600,389,41,9.534883720930234
"Census Tract 5807, Wayne County, Michigan",973,26,163,580700,875,98,10.071942446043165
"Census Tract 5808, Wayne County, Michigan",227,26,163,580800,212,15,6.607929515418502
"Census Tract 5809, Wayne County, Michigan",424,26,163,580900,351,73,17.21698113207547
"Census Tract 5811, Wayne County, Michigan",719,26,163,581100,356,363,50.48678720445062
"Census Tract 5812, Wayne County, Michigan",816,26,163,581200,591,225,27.573529411764707
"Census Tract 5815, Wayne County, Michigan",112,26,163,581500,106,6,5.357142857142857
"Census Tract 5816, Wayne County, Michigan",1139,26,163,581600,854,285,25.021949078138718
"Census Tract 5818, Wayne County, Michigan",191,26,163,581800,191,0,0.0
"Census Tract 5819, Wayne County, Michigan",179,26,163,581900,144,35,19.553072625698324
"Census Tract 5820, Wayne County, Michigan",997,26,163,582000,621,376,37.71313941825476
"Census Tract 5821, Wayne County, Michigan",198,26,163,582100,198,0,0.0
"Census Tract 5830, Wayne County, Michigan",261,26,163,583000,218,43,16.47509578544061
"Census Tract 5831, Wayne County, Michigan",338,26,163,583100,252,86,25.443786982248522
"Census Tract 5832, Wayne County, Michigan",368,26,163,583200,225,143,38.858695652173914
"Census Tract 5833, Wayne County, Michigan",279,26,163,583300,169,110,39.42652329749104
"Census Tract 5834, Wayne County, Michigan",381,26,163,583400,341,40,10.498687664041995
"Census Tract 5835, Wayne County, Michigan",144,26,163,583500,99,45,31.25
"Census Tract 5836, Wayne County, Michigan",170,26,163,583600,160,10,5.88235294117647
"Census Tract 5837, Wayne County, Michigan",209,26,163,583700,110,99,47.368421052631575
"Census Tract 5838, Wayne County, Michigan",655,26,163,583800,330,325,49.61832061068702
"Census Tract 5839, Wayne County, Michigan",818,26,163,583900,400,418,51.1002444987775
"Census Tract 5840, Wayne County, Michigan",605,26,163,584000,227,378,62.47933884297521
"Census Tract 5841, Wayne County, Michigan",86,26,163,584100,86,0,0.0
"Census Tract 5842, Wayne County, Michigan",616,26,163,584200,262,354,57.467532467532465
"Census Tract 5843, Wayne County, Michigan",466,26,163,584300,259,207,44.4206008583691
"Census Tract 5844, Wayne County, Michigan",577,26,163,584400,289,288,49.91334488734835
"Census Tract 5845, Wayne County, Michigan",288,26,163,584500,106,182,63.19444444444444
"Census Tract 5846, Wayne County, Michigan",526,26,163,584600,208,318,60.45627376425855
"Census Tract 5847, Wayne County, Michigan",143,26,163,584700,122,21,14.685314685314685
"Census Tract 5848, Wayne County, Michigan",1703,26,163,584800,312,1391,81.67938931297711
"Census Tract 5855, Wayne County, Michigan",203,26,163,585500,131,72,35.467980295566505
"Census Tract 5856, Wayne County, Michigan",631,26,163,585600,161,470,74.48494453248811
"Census Tract 5857, Wayne County, Michigan",192,26,163,585700,85,107,55.729166666666664
"Census Tract 5858, Wayne County, Michigan",553,26,163,585800,137,416,75.22603978300181
"Census Tract 5859, Wayne County, Michigan",488,26,163,585900,292,196,40.16393442622951
"Census Tract 5862, Wayne County, Michigan",896,26,163,586200,244,652,72.76785714285714
"Census Tract 5863, Wayne County, Michigan",68,26,163,586300,68,0,0.0
"Census Tract 5870, Wayne County, Michigan",621,26,163,587000,467,154,24.798711755233494
"Census Tract 5879, Wayne County, Michigan",582,26,163,587900,303,279,47.93814432989691
"Census Tract 5880, Wayne County, Michigan",1552,26,163,588000,730,822,52.9639175257732
"Census Tract 5881, Wayne County, Michigan",192,26,163,588100,118,74,38.54166666666667
"Census Tract 5882, Wayne County, Michigan",1391,26,163,588200,584,807,58.01581595974119
"Census Tract 5883, Wayne County, Michigan",145,26,163,588300,114,31,21.379310344827587
"Census Tract 5884, Wayne County, Michigan",164,26,163,588400,114,50,30.48780487804878
"Census Tract 5893, Wayne County, Michigan",108,26,163,589300,98,10,9.25925925925926
"Census Tract 5894, Wayne County, Michigan",380,26,163,589400,380,0,0.0
"Census Tract 5904, Wayne County, Michigan",298,26,163,590400,209,89,29.86577181208054
"Census Tract 5905, Wayne County, Michigan",152,26,163,590500,152,0,0.0
"Census Tract 5906, Wayne County, Michigan",53,26,163,590600,49,4,7.547169811320755
"Census Tract 5915.01, Wayne County, Michigan",356,26,163,591501,140,216,60.67415730337079
"Census Tract 5915.02, Wayne County, Michigan",530,26,163,591502,346,184,34.71698113207547
"Census Tract 5916, Wayne County, Michigan",41,26,163,591600,28,13,31.70731707317073
"Census Tract 5917, Wayne County, Michigan",373,26,163,591700,317,56,15.013404825737265
"Census Tract 5918, Wayne County, Michigan",969,26,163,591800,700,269,27.76057791537668
"Census Tract 5919, Wayne County, Michigan",429,26,163,591900,246,183,42.65734265734265
"Census Tract 5920, Wayne County, Michigan",94,26,163,592000,89,5,5.319148936170213
"Census Tract 5930, Wayne County, Michigan",661,26,163,593000,428,233,35.24962178517398
"Census Tract 5932, Wayne County, Michigan",509,26,163,593200,402,107,21.021611001964637
"Census Tract 5933, Wayne County, Michigan",302,26,163,593300,245,57,18.874172185430464
"Census Tract 5940, Wayne County, Michigan",522,26,163,594000,495,27,5.172413793103448
"Census Tract 5941, Wayne County, Michigan",303,26,163,594100,276,27,8.91089108910891
"Census Tract 5942, Wayne County, Michigan",17,26,163,594200,17,0,0.0
"Census Tract 5943, Wayne County, Michigan",116,26,163,594300,116,0,0.0
"Census Tract 5944, Wayne County, Michigan",429,26,163,594400,370,59,13.752913752913754
"Census Tract 5945, Wayne County, Michigan",289,26,163,594500,227,62,21.453287197231834
"Census Tract 5950, Wayne County, Michigan",407,26,163,595000,392,15,3.6855036855036856
"Census Tract 5951, Wayne County, Michigan",838,26,163,595100,651,187,22.315035799522672
"Census Tract 5952, Wayne County, Michigan",693,26,163,595200,592,101,14.574314574314574
"Census Tract 5961, Wayne County, Michigan",94,26,163,596100,75,19,20.212765957446805
"Census Tract 5962, Wayne County, Michigan",145,26,163,596200,110,35,24.137931034482758
"Census Tract 5963, Wayne County, Michigan",48,26,163,596300,28,20,41.66666666666667
"Census Tract 5970, Wayne County, Michigan",377,26,163,597000,334,43,11.405835543766578
"Census Tract 5980, Wayne County, Michigan",365,26,163,598000,324,41,11.232876712328768
"Census Tract 5990, Wayne County, Michigan",522,26,163,599000,401,121,23.18007662835249
"Census Tract 5991, Wayne County, Michigan",414,26,163,599100,303,111,26.811594202898554
"Census Tract 6200, St. Clair County, Michigan",1076,26,147,620000,777,299,27.788104089219328
"Census Tract 6210, St. Clair County, Michigan",769,26,147,621000,588,181,23.5370611183355
"Census Tract 6220, St. Clair County, Michigan",567,26,147,622000,416,151,26.63139329805996
"Census Tract 6230, St. Clair County, Michigan",590,26,147,623000,537,53,8.983050847457626
"Census Tract 6240, St. Clair County, Michigan",693,26,147,624000,547,146,21.06782106782107
"Census Tract 6250, St. Clair County, Michigan",551,26,147,625000,454,97,17.604355716878402
"Census Tract 6260, St. Clair County, Michigan",331,26,147,626000,275,56,16.91842900302115
"Census Tract 6270, St. Clair County, Michigan",233,26,147,627000,206,27,11.587982832618025
"Census Tract 6280, St. Clair County, Michigan",431,26,147,628000,311,120,27.842227378190255
"Census Tract 6290, St. Clair County, Michigan",676,26,147,629000,595,81,11.982248520710058
"Census Tract 6301, St. Clair County, Michigan",258,26,147,630100,210,48,18.6046511627907
"Census Tract 6304, St. Clair County, Michigan",325,26,147,630400,303,22,6.769230769230769
"Census Tract 6311, St. Clair County, Michigan",154,26,147,631100,124,30,19.480519480519483
"Census Tract 6316, St. Clair County, Michigan",448,26,147,631600,423,25,5.580357142857143
"Census Tract 6320, St. Clair County, Michigan",277,26,147,632000,222,55,19.855595667870034
"Census Tract 6331, St. Clair County, Michigan",28,26,147,633100,28,0,0.0
"Census Tract 6332, St. Clair County, Michigan",116,26,147,633200,102,14,12.068965517241379
"Census Tract 6341, St. Clair County, Michigan",52,26,147,634100,29,23,44.230769230769226
"Census Tract 6346, St. Clair County, Michigan",266,26,147,634600,266,0,0.0
"Census Tract 6350, St. Clair County, Michigan",699,26,147,635000,658,41,5.865522174535051
"Census Tract 6360, St. Clair County, Michigan",799,26,147,636000,534,265,33.166458072590736
"Census Tract 6371, St. Clair County, Michigan",52,26,147,637100,52,0,0.0
"Census Tract 6372, St. Clair County, Michigan",412,26,147,637200,338,74,17.96116504854369
"Census Tract 6373, St. Clair County, Michigan",341,26,147,637300,277,64,18.7683284457478
"Census Tract 6401, St. Clair County, Michigan",78,26,147,640100,78,0,0.0
"Census Tract 6402, St. Clair County, Michigan",64,26,147,640200,64,0,0.0
"Census Tract 6406, St. Clair County, Michigan",89,26,147,640600,89,0,0.0
"Census Tract 6410, St. Clair County, Michigan",44,26,147,641000,44,0,0.0
"Census Tract 6420, St. Clair County, Michigan",434,26,147,642000,434,0,0.0
"Census Tract 6430, St. Clair County, Michigan",347,26,147,643000,347,0,0.0
"Census Tract 6440, St. Clair County, Michigan",518,26,147,644000,506,12,2.3166023166023164
"Census Tract 6450, St. Clair County, Michigan",107,26,147,645000,107,0,0.0
"Census Tract 6460, St. Clair County, Michigan",296,26,147,646000,286,10,3.3783783783783785
"Census Tract 6470, St. Clair County, Michigan",148,26,147,647000,131,17,11.486486486486488
"Census Tract 6480, St. Clair County, Michigan",25,26,147,648000,25,0,0.0
"Census Tract 6490, St. Clair County, Michigan",515,26,147,649000,493,22,4.271844660194175
"Census Tract 6501, St. Clair County, Michigan",199,26,147,650100,177,22,11.055276381909549
"Census Tract 6502, St. Clair County, Michigan",47,26,147,650200,47,0,0.0
"Census Tract 6511, St. Clair County, Michigan",66,26,147,651100,66,0,0.0
"Census Tract 6512, St. Clair County, Michigan",33,26,147,651200,33,0,0.0
"Census Tract 6516, St. Clair County, Michigan",203,26,147,651600,158,45,22.167487684729064
"Census Tract 6521, St. Clair County, Michigan",100,26,147,652100,100,0,0.0
"Census Tract 6526, St. Clair County, Michigan",85,26,147,652600,85,0,0.0
"Census Tract 6551, St. Clair County, Michigan",436,26,147,655100,415,21,4.81651376146789
"Census Tract 6556, St. Clair County, Michigan",72,26,147,655600,58,14,19.444444444444446
"Census Tract 6571, St. Clair County, Michigan",275,26,147,657100,235,40,14.545454545454545
"Census Tract 6572, St. Clair County, Michigan",159,26,147,657200,145,14,8.80503144654088
"Census Tract 6581, St. Clair County, Michigan",36,26,147,658100,36,0,0.0
"Census Tract 6585, St. Clair County, Michigan",186,26,147,658500,186,0,0.0
"Census Tract 7101, Livingston County, Michigan",45,26,93,710100,45,0,0.0
"Census Tract 7103, Livingston County, Michigan",310,26,93,710300,262,48,15.483870967741936
"Census Tract 7105, Livingston County, Michigan",64,26,93,710500,64,0,0.0
"Census Tract 7107, Livingston County, Michigan",66,26,93,710700,53,13,19.696969696969695
"Census Tract 7110, Livingston County, Michigan",118,26,93,711000,109,9,7.627118644067797
"Census Tract 7121.01, Livingston County, Michigan",226,26,93,712101,226,0,0.0
"Census Tract 7121.02, Livingston County, Michigan",72,26,93,712102,72,0,0.0
"Census Tract 7126.01, Livingston County, Michigan",220,26,93,712601,220,0,0.0
"Census Tract 7126.02, Livingston County, Michigan",68,26,93,712602,61,7,10.294117647058822
"Census Tract 7131, Livingston County, Michigan",156,26,93,713100,149,7,4.487179487179487
"Census Tract 7133, Livingston County, Michigan",190,26,93,713300,190,0,0.0
"Census Tract 7135, Livingston County, Michigan",239,26,93,713500,134,105,43.93305439330544
"Census Tract 7137, Livingston County, Michigan",327,26,93,713700,291,36,11.009174311926607
"Census Tract 7201, Livingston County, Michigan",95,26,93,720100,77,18,18.947368421052634
"Census Tract 7211, Livingston County, Michigan",67,26,93,721100,61,6,8.955223880597014
"Census Tract 7221, Livingston County, Michigan",161,26,93,722100,161,0,0.0
"Census Tract 7223, Livingston County, Michigan",413,26,93,722300,391,22,5.326876513317192
"Census Tract 7225, Livingston County, Michigan",82,26,93,722500,82,0,0.0
"Census Tract 7240.01, Livingston County, Michigan",105,26,93,724001,99,6,5.714285714285714
"Census Tract 7240.02, Livingston County, Michigan",51,26,93,724002,51,0,0.0
"Census Tract 7240.03, Livingston County, Michigan",55,26,93,724003,55,0,0.0
"Census Tract 7250, Livingston County, Michigan",1415,26,93,725000,1254,161,11.37809187279152
"Census Tract 7251, Livingston County, Michigan",942,26,93,725100,876,66,7.006369426751593
"Census Tract 7301.01, Livingston County, Michigan",67,26,93,730101,67,0,0.0
"Census Tract 7301.02, Livingston County, Michigan",23,26,93,730102,16,7,30.434782608695656
"Census Tract 7306, Livingston County, Michigan",93,26,93,730600,93,0,0.0
"Census Tract 7311, Livingston County, Michigan",78,26,93,731100,78,0,0.0
"Census Tract 7321, Livingston County, Michigan",123,26,93,732100,123,0,0.0
"Census Tract 7331, Livingston County, Michigan",8,26,93,733100,8,0,0.0
"Census Tract 7336.01, Livingston County, Michigan",128,26,93,733601,128,0,0.0
"Census Tract 7336.02, Livingston County, Michigan",282,26,93,733602,278,4,1.4184397163120568
"Census Tract 7402, Livingston County, Michigan",31,26,93,740200,31,0,0.0
"Census Tract 7403, Livingston County, Michigan",22,26,93,740300,22,0,0.0
"Census Tract 7405, Livingston County, Michigan",106,26,93,740500,106,0,0.0
"Census Tract 7406, Livingston County, Michigan",11,26,93,740600,11,0,0.0
"Census Tract 7407, Livingston County, Michigan",7,26,93,740700,7,0,0.0
"Census Tract 7408, Livingston County, Michigan",52,26,93,740800,43,9,17.307692307692307
"Census Tract 7409, Livingston County, Michigan",82,26,93,740900,82,0,0.0
"Census Tract 7411, Livingston County, Michigan",738,26,93,741100,656,82,11.11111111111111
"Census Tract 7416.01, Livingston County, Michigan",602,26,93,741601,548,54,8.970099667774086
"Census Tract 7416.02, Livingston County, Michigan",102,26,93,741602,94,8,7.8431372549019605
"Census Tract 7422.01, Livingston County, Michigan",254,26,93,742201,227,27,10.62992125984252
"Census Tract 7422.02, Livingston County, Michigan",100,26,93,742202,90,10,10.0
"Census Tract 7424.01, Livingston County, Michigan",416,26,93,742401,378,38,9.134615384615383
"Census Tract 7424.02, Livingston County, Michigan",474,26,93,742402,407,67,14.135021097046414
"Census Tract 7425, Livingston County, Michigan",12,26,93,742500,12,0,0.0
"Census Tract 7427, Livingston County, Michigan",61,26,93,742700,29,32,52.459016393442624
"Census Tract 7429, Livingston County, Michigan",13,26,93,742900,13,0,0.0
"Census Tract 7433, Livingston County, Michigan",29,26,93,743300,29,0,0.0
"Census Tract 7434, Livingston County, Michigan",14,26,93,743400,14,0,0.0
"Census Tract 7435, Livingston County, Michigan",49,26,93,743500,49,0,0.0
"Census Tract 7436, Livingston County, Michigan",86,26,93,743600,86,0,0.0
"Census Tract 7437, Livingston County, Michigan",83,26,93,743700,83,0,0.0
"Census Tract 7438, Livingston County, Michigan",110,26,93,743800,59,51,46.36363636363636
"Census Tract 7439, Livingston County, Michigan",80,26,93,743900,80,0,0.0
"Census Tract 7442, Livingston County, Michigan",201,26,93,744200,172,29,14.427860696517413
"Census Tract 7444, Livingston County, Michigan",56,26,93,744400,52,4,7.142857142857142
"Census Tract 7446, Livingston County, Michigan",38,26,93,744600,38,0,0.0
"Census Tract 7447, Livingston County, Michigan",94,26,93,744700,94,0,0.0
"Census Tract 7448, Livingston County, Michigan",17,26,93,744800,17,0,0.0
"Census Tract 7449, Livingston County, Michigan",282,26,93,744900,270,12,4.25531914893617
"Census Tract 8301, Monroe County, Michigan",335,26,115,830100,273,62,18.507462686567163
"Census Tract 8302, Monroe County, Michigan",220,26,115,830200,176,44,20.0
"Census Tract 8303, Monroe County, Michigan",207,26,115,830300,199,8,3.864734299516908
"Census Tract 8304, Monroe County, Michigan",161,26,115,830400,161,0,0.0
"Census Tract 8305, Monroe County, Michigan",126,26,115,830500,124,2,1.5873015873015872
"Census Tract 8306, Monroe County, Michigan",178,26,115,830600,132,46,25.842696629213485
"Census Tract 8307, Monroe County, Michigan",292,26,115,830700,257,35,11.986301369863012
"Census Tract 8308, Monroe County, Michigan",697,26,115,830800,689,8,1.1477761836441895
"Census Tract 8309, Monroe County, Michigan",55,26,115,830900,55,0,0.0
"Census Tract 8310, Monroe County, Michigan",134,26,115,831000,134,0,0.0
"Census Tract 8311, Monroe County, Michigan",253,26,115,831100,220,33,13.043478260869565
"Census Tract 8312, Monroe County, Michigan",469,26,115,831200,469,0,0.0
"Census Tract 8313, Monroe County, Michigan",272,26,115,831300,251,21,7.720588235294118
"Census Tract 8314, Monroe County, Michigan",1539,26,115,831400,1198,341,22.157244964262507
"Census Tract 8315, Monroe County, Michigan",560,26,115,831500,529,31,5.535714285714286
"Census Tract 8316, Monroe County, Michigan",530,26,115,831600,475,55,10.377358490566039
"Census Tract 8317, Monroe County, Michigan",377,26,115,831700,306,71,18.83289124668435
"Census Tract 8318, Monroe County, Michigan",132,26,115,831800,104,28,21.21212121212121
"Census Tract 8319, Monroe County, Michigan",265,26,115,831900,233,32,12.075471698113208
"Census Tract 8320, Monroe County, Michigan",214,26,115,832000,148,66,30.8411214953271
"Census Tract 8321, Monroe County, Michigan",906,26,115,832100,835,71,7.836644591611479
"Census Tract 8322, Monroe County, Michigan",273,26,115,832200,255,18,6.593406593406594
"Census Tract 8323, Monroe County, Michigan",274,26,115,832300,274,0,0.0
"Census Tract 8324, Monroe County, Michigan",411,26,115,832400,321,90,21.897810218978105
"Census Tract 8325, Monroe County, Michigan",424,26,115,832500,340,84,19.81132075471698
"Census Tract 8326, Monroe County, Michigan",40,26,115,832600,31,9,22.5
"Census Tract 8327, Monroe County, Michigan",98,26,115,832700,98,0,0.0
"Census Tract 8328, Monroe County, Michigan",139,26,115,832800,99,40,28.776978417266186
"Census Tract 8329, Monroe County, Michigan",198,26,115,832900,182,16,8.080808080808081
"Census Tract 8330, Monroe County, Michigan",200,26,115,833000,158,42,21.0
"Census Tract 8331, Monroe County, Michigan",181,26,115,833100,163,18,9.94475138121547
"Census Tract 8332, Monroe County, Michigan",79,26,115,833200,79,0,0.0
"Census Tract 8333, Monroe County, Michigan",289,26,115,833300,289,0,0.0
"Census Tract 8335, Monroe County, Michigan",564,26,115,833500,495,69,12.23404255319149
"Census Tract 8336, Monroe County, Michigan",163,26,115,833600,149,14,8.588957055214724
"Census Tract 8337, Monroe County, Michigan",202,26,115,833700,202,0,0.0
"Census Tract 8338, Monroe County, Michigan",515,26,115,833800,354,161,31.2621359223301
"Census Tract 8339, Monroe County, Michigan",179,26,115,833900,171,8,4.4692737430167595
"Census Tract 9101, Montmorency County, Michigan",197,26,119,910100,184,13,6.598984771573605
"Census Tract 9102, Montmorency County, Michigan",96,26,119,910200,83,13,13.541666666666666
"Census Tract 9103, Montmorency County, Michigan",116,26,119,910300,112,4,3.4482758620689653
"Census Tract 9104, Montmorency County, Michigan",127,26,119,910400,127,0,0.0
"Census Tract 9105, Montmorency County, Michigan",174,26,119,910500,174,0,0.0
"Census Tract 9401, Isabella County, Michigan",200,26,73,940100,186,14,7.000000000000001
"Census Tract 9402, Isabella County, Michigan",363,26,73,940200,241,122,33.608815426997246
"Census Tract 9403, Isabella County, Michigan",690,26,73,940300,566,124,17.971014492753625
"Census Tract 9404, Isabella County, Michigan",526,26,73,940400,422,104,19.771863117870723
"Census Tract 9405, Isabella County, Michigan",736,26,73,940500,630,106,14.402173913043478
"Census Tract 9406, Isabella County, Michigan",286,26,73,940600,244,42,14.685314685314685
"Census Tract 9501, Mackinac County, Michigan",148,26,97,950100,145,3,2.027027027027027
"Census Tract 9501, Otsego County, Michigan",203,26,137,950100,192,11,5.41871921182266
"Census Tract 9501, Mason County, Michigan",62,26,105,950100,60,2,3.225806451612903
"Census Tract 9501, Branch County, Michigan",181,26,23,950100,171,10,5.524861878453039
"Census Tract 9501, Dickinson County, Michigan",83,26,43,950100,83,0,0.0
"Census Tract 9501, Huron County, Michigan",94,26,63,950100,72,22,23.404255319148938
"Census Tract 9501, Gogebic County, Michigan",139,26,53,950100,23,116,83.45323741007195
"Census Tract 9501, Ogemaw County, Michigan",155,26,129,950100,129,26,16.7741935483871
"Census Tract 9501, Presque Isle County, Michigan",42,26,141,950100,42,0,0.0
"Census Tract 9502, Presque Isle County, Michigan",242,26,141,950200,242,0,0.0
"Census Tract 9502, Dickinson County, Michigan",125,26,43,950200,125,0,0.0
"Census Tract 9502, Kalkaska County, Michigan",267,26,79,950200,250,17,6.367041198501873
"Census Tract 9502, Ogemaw County, Michigan",152,26,129,950200,141,11,7.236842105263158
"Census Tract 9502, Mackinac County, Michigan",224,26,97,950200,180,44,19.642857142857142
"Census Tract 9502, Mason County, Michigan",102,26,105,950200,102,0,0.0
"Census Tract 9502, Huron County, Michigan",80,26,63,950200,77,3,3.75
"Census Tract 9502, Branch County, Michigan",416,26,23,950200,414,2,0.4807692307692308
"Census Tract 9502, Gogebic County, Michigan",172,26,53,950200,172,0,0.0
"Census Tract 9502, Otsego County, Michigan",209,26,137,950200,199,10,4.784688995215311
"Census Tract 9503, Dickinson County, Michigan",521,26,43,950300,520,1,0.19193857965451055
"Census Tract 9503, Mackinac County, Michigan",113,26,97,950300,105,8,7.079646017699115
"Census Tract 9503, Presque Isle County, Michigan",78,26,141,950300,60,18,23.076923076923077
"Census Tract 9503, Gogebic County, Michigan",250,26,53,950300,248,2,0.8
"Census Tract 9503, Ogemaw County, Michigan",47,26,129,950300,43,4,8.51063829787234
"Census Tract 9503, Mason County, Michigan",116,26,105,950300,111,5,4.310344827586207
"Census Tract 9503, Branch County, Michigan",220,26,23,950300,192,28,12.727272727272727
"Census Tract 9503, Huron County, Michigan",134,26,63,950300,134,0,0.0
"Census Tract 9503, Otsego County, Michigan",1210,26,137,950300,1111,99,8.181818181818182
"Census Tract 9503, Kalkaska County, Michigan",594,26,79,950300,536,58,9.764309764309765
"Census Tract 9504, Gogebic County, Michigan",5,26,53,950400,4,1,20.0
"Census Tract 9504, Mason County, Michigan",1081,26,105,950400,1054,27,2.497687326549491
"Census Tract 9504, Dickinson County, Michigan",488,26,43,950400,471,17,3.483606557377049
"Census Tract 9504, Mackinac County, Michigan",460,26,97,950400,193,267,58.04347826086956
"Census Tract 9504, Otsego County, Michigan",97,26,137,950400,89,8,8.24742268041237
"Census Tract 9504, Kalkaska County, Michigan",197,26,79,950400,184,13,6.598984771573605
"Census Tract 9504, Ogemaw County, Michigan",129,26,129,950400,76,53,41.08527131782946
"Census Tract 9504, Presque Isle County, Michigan",159,26,141,950400,150,9,5.660377358490567
"Census Tract 9504, Huron County, Michigan",44,26,63,950400,44,0,0.0
"Census Tract 9505, Dickinson County, Michigan",341,26,43,950500,341,0,0.0
"Census Tract 9505, Gogebic County, Michigan",319,26,53,950500,266,53,16.614420062695924
"Census Tract 9505, Mason County, Michigan",428,26,105,950500,373,55,12.850467289719624
"Census Tract 9505, Huron County, Michigan",163,26,63,950500,150,13,7.975460122699387
"Census Tract 9505, Presque Isle County, Michigan",115,26,141,950500,112,3,2.608695652173913
"Census Tract 9505, Otsego County, Michigan",239,26,137,950500,239,0,0.0
"Census Tract 9505, Mackinac County, Michigan",538,26,97,950500,293,245,45.539033457249076
"Census Tract 9505, Ogemaw County, Michigan",705,26,129,950500,659,46,6.524822695035461
"Census Tract 9506, Ogemaw County, Michigan",128,26,129,950600,124,4,3.125
"Census Tract 9506, Mason County, Michigan",661,26,105,950600,617,44,6.656580937972769
"Census Tract 9506, Dickinson County, Michigan",797,26,43,950600,721,76,9.535759096612297
"Census Tract 9506, Huron County, Michigan",207,26,63,950600,192,15,7.246376811594203
"Census Tract 9506, Gogebic County, Michigan",485,26,53,950600,465,20,4.123711340206185
"Census Tract 9506, Presque Isle County, Michigan",14,26,141,950600,14,0,0.0
"Census Tract 9506, Otsego County, Michigan",140,26,137,950600,140,0,0.0
"Census Tract 9506.01, Kalkaska County, Michigan",120,26,79,950601,115,5,4.166666666666666
"Census Tract 9506.02, Kalkaska County, Michigan",66,26,79,950602,62,4,6.0606060606060606
"Census Tract 9507, Huron County, Michigan",369,26,63,950700,347,22,5.9620596205962055
"Census Tract 9507, Dickinson County, Michigan",188,26,43,950700,181,7,3.723404255319149
"Census Tract 9507, Mason County, Michigan",216,26,105,950700,199,17,7.87037037037037
"Census Tract 9507, Gogebic County, Michigan",150,26,53,950700,150,0,0.0
"Census Tract 9508, Mason County, Michigan",154,26,105,950800,128,26,16.883116883116884
"Census Tract 9508, Branch County, Michigan",289,26,23,950800,283,6,2.0761245674740483
"Census Tract 9508, Huron County, Michigan",228,26,63,950800,202,26,11.403508771929824
"Census Tract 9509, Ogemaw County, Michigan",392,26,129,950900,361,31,7.908163265306123
"Census Tract 9509, Branch County, Michigan",152,26,23,950900,139,13,8.552631578947368
"Census Tract 9509, Huron County, Michigan",192,26,63,950900,188,4,2.083333333333333
"Census Tract 9510, Branch County, Michigan",90,26,23,951000,90,0,0.0
"Census Tract 9510, Huron County, Michigan",629,26,63,951000,579,50,7.94912559618442
"Census Tract 9511, Branch County, Michigan",164,26,23,951100,149,15,9.146341463414634
"Census Tract 9511, Huron County, Michigan",133,26,63,951100,122,11,8.270676691729323
"Census Tract 9512, Huron County, Michigan",375,26,63,951200,352,23,6.133333333333333
"Census Tract 9512, Branch County, Michigan",538,26,23,951200,507,31,5.762081784386617
"Census Tract 9513, Branch County, Michigan",484,26,23,951300,439,45,9.297520661157025
"Census Tract 9514, Branch County, Michigan",681,26,23,951400,622,59,8.663729809104257
"Census Tract 9515, Branch County, Michigan",370,26,23,951500,267,103,27.837837837837835
"Census Tract 9516, Branch County, Michigan",707,26,23,951600,499,208,29.42008486562942
"Census Tract 9601, Crawford County, Michigan",131,26,39,960100,131,0,0.0
"Census Tract 9601, Menominee County, Michigan",268,26,109,960100,241,27,10.074626865671641
"Census Tract 9601, Cheboygan County, Michigan",165,26,31,960100,149,16,9.696969696969697
"Census Tract 9601, Antrim County, Michigan",137,26,9,960100,137,0,0.0
"Census Tract 9601, Mecosta County, Michigan",177,26,107,960100,171,6,3.389830508474576
"Census Tract 9601, Luce County, Michigan",391,26,95,960100,327,64,16.36828644501279
"Census Tract 9601, Lake County, Michigan",85,26,85,960100,66,19,22.35294117647059
"Census Tract 9601, Missaukee County, Michigan",311,26,113,960100,278,33,10.610932475884244
"Census Tract 9602, Antrim County, Michigan",142,26,9,960200,125,17,11.971830985915492
"Census Tract 9602, Mecosta County, Michigan",147,26,107,960200,140,7,4.761904761904762
"Census Tract 9602, Cheboygan County, Michigan",425,26,31,960200,407,18,4.235294117647059
"Census Tract 9602, Luce County, Michigan",67,26,95,960200,43,24,35.82089552238806
"Census Tract 9602, Missaukee County, Michigan",287,26,113,960200,287,0,0.0
"Census Tract 9602, Menominee County, Michigan",342,26,109,960200,205,137,40.058479532163744
"Census Tract 9602, Crawford County, Michigan",349,26,39,960200,335,14,4.011461318051576
"Census Tract 9603, Cheboygan County, Michigan",505,26,31,960300,362,143,28.316831683168314
"Census Tract 9603, Menominee County, Michigan",163,26,109,960300,143,20,12.269938650306749
"Census Tract 9603, Crawford County, Michigan",536,26,39,960300,496,40,7.462686567164178
"Census Tract 9603, Mecosta County, Michigan",114,26,107,960300,114,0,0.0
"Census Tract 9603, Missaukee County, Michigan",412,26,113,960300,374,38,9.223300970873787
"Census Tract 9603, Antrim County, Michigan",150,26,9,960300,143,7,4.666666666666667
"Census Tract 9604, Mecosta County, Michigan",420,26,107,960400,353,67,15.95238095238095
"Census Tract 9604, Menominee County, Michigan",100,26,109,960400,88,12,12.0
"Census Tract 9604, Antrim County, Michigan",235,26,9,960400,232,3,1.276595744680851
"Census Tract 9604, Crawford County, Michigan",68,26,39,960400,60,8,11.76470588235294
"Census Tract 9604, Cheboygan County, Michigan",101,26,31,960400,89,12,11.881188118811881
"Census Tract 9604, Missaukee County, Michigan",194,26,113,960400,152,42,21.649484536082475
"Census Tract 9605, Menominee County, Michigan",293,26,109,960500,293,0,0.0
"Census Tract 9605, Antrim County, Michigan",117,26,9,960500,75,42,35.8974358974359
"Census Tract 9605, Crawford County, Michigan",71,26,39,960500,71,0,0.0
"Census Tract 9605, Mecosta County, Michigan",1051,26,107,960500,996,55,5.233111322549953
"Census Tract 9605, Cheboygan County, Michigan",88,26,31,960500,65,23,26.136363636363637
"Census Tract 9606, Menominee County, Michigan",555,26,109,960600,547,8,1.4414414414414414
"Census Tract 9606, Cheboygan County, Michigan",218,26,31,960600,218,0,0.0
"Census Tract 9606, Mecosta County, Michigan",699,26,107,960600,596,103,14.735336194563661
"Census Tract 9606, Antrim County, Michigan",218,26,9,960600,206,12,5.5045871559633035
"Census Tract 9607, Menominee County, Michigan",647,26,109,960700,572,75,11.591962905718702
"Census Tract 9607, Antrim County, Michigan",279,26,9,960700,256,23,8.24372759856631
"Census Tract 9607, Mecosta County, Michigan",918,26,107,960700,647,271,29.520697167755994
"Census Tract 9607, Cheboygan County, Michigan",284,26,31,960700,252,32,11.267605633802818
"Census Tract 9608, Cheboygan County, Michigan",187,26,31,960800,183,4,2.13903743315508
"Census Tract 9608, Mecosta County, Michigan",234,26,107,960800,228,6,2.564102564102564
"Census Tract 9609, Mecosta County, Michigan",202,26,107,960900,199,3,1.4851485148514851
"Census Tract 9610, Mecosta County, Michigan",252,26,107,961000,221,31,12.3015873015873
"Census Tract 9611, Lake County, Michigan",197,26,85,961100,109,88,44.67005076142132
"Census Tract 9612, Lake County, Michigan",336,26,85,961200,217,119,35.41666666666667
"Census Tract 9613, Lake County, Michigan",116,26,85,961300,115,1,0.8620689655172413
"Census Tract 9701, Ontonagon County, Michigan",69,26,131,970100,63,6,8.695652173913043
"Census Tract 9701, Arenac County, Michigan",81,26,11,970100,75,6,7.4074074074074066
"Census Tract 9701, Emmet County, Michigan",173,26,47,970100,152,21,12.138728323699421
"Census Tract 9701, Montcalm County, Michigan",317,26,117,970100,303,14,4.416403785488959
"Census Tract 9701, Sanilac County, Michigan",79,26,151,970100,79,0,0.0
"Census Tract 9701, Alcona County, Michigan",126,26,1,970100,118,8,6.349206349206349
"Census Tract 9701, Chippewa County, Michigan",111,26,33,970100,37,74,66.66666666666666
"Census Tract 9701, Osceola County, Michigan",278,26,133,970100,263,15,5.39568345323741
"Census Tract 9701, Newaygo County, Michigan",268,26,123,970100,236,32,11.940298507462686
"Census Tract 9701, Roscommon County, Michigan",138,26,143,970100,129,9,6.521739130434782
"Census Tract 9701, Delta County, Michigan",66,26,41,970100,65,1,1.5151515151515151
"Census Tract 9701, Leelanau County, Michigan",86,26,89,970100,67,19,22.093023255813954
"Census Tract 9702, Chippewa County, Michigan",663,26,33,970200,278,385,58.06938159879337
"Census Tract 9702, Roscommon County, Michigan",102,26,143,970200,79,23,22.54901960784314
"Census Tract 9702, Osceola County, Michigan",179,26,133,970200,179,0,0.0
"Census Tract 9702, Delta County, Michigan",145,26,41,970200,128,17,11.724137931034482
"Census Tract 9702, Sanilac County, Michigan",155,26,151,970200,124,31,20.0
"Census Tract 9702, Leelanau County, Michigan",360,26,89,970200,205,155,43.05555555555556
"Census Tract 9702, Ontonagon County, Michigan",198,26,131,970200,198,0,0.0
"Census Tract 9702, Emmet County, Michigan",404,26,47,970200,367,37,9.158415841584159
"Census Tract 9702, Arenac County, Michigan",134,26,11,970200,131,3,2.2388059701492535
"Census Tract 9702, Montcalm County, Michigan",421,26,117,970200,408,13,3.0878859857482186
"Census Tract 9702.01, Oscoda County, Michigan",38,26,135,970201,38,0,0.0
"Census Tract 9702.02, Oscoda County, Michigan",90,26,135,970202,88,2,2.2222222222222223
"Census Tract 9703, Oscoda County, Michigan",154,26,135,970300,150,4,2.5974025974025974
"Census Tract 9703, Leelanau County, Michigan",148,26,89,970300,114,34,22.972972972972975
"Census Tract 9703, Montcalm County, Michigan",156,26,117,970300,119,37,23.717948717948715
"Census Tract 9703, Delta County, Michigan",105,26,41,970300,102,3,2.857142857142857
"Census Tract 9703, Chippewa County, Michigan",1229,26,33,970300,1022,207,16.842961757526446
"Census Tract 9703, Newaygo County, Michigan",235,26,123,970300,218,17,7.234042553191489
"Census Tract 9703, Sanilac County, Michigan",236,26,151,970300,204,32,13.559322033898304
"Census Tract 9703, Emmet County, Michigan",251,26,47,970300,224,27,10.756972111553784
"Census Tract 9703, Osceola County, Michigan",191,26,133,970300,173,18,9.424083769633508
"Census Tract 9703, Roscommon County, Michigan",290,26,143,970300,284,6,2.0689655172413794
"Census Tract 9703, Arenac County, Michigan",147,26,11,970300,141,6,4.081632653061225
"Census Tract 9703, Ontonagon County, Michigan",62,26,131,970300,59,3,4.838709677419355
"Census Tract 9704, Leelanau County, Michigan",35,26,89,970400,35,0,0.0
"Census Tract 9704, Roscommon County, Michigan",50,26,143,970400,50,0,0.0
"Census Tract 9704, Oscoda County, Michigan",162,26,135,970400,117,45,27.77777777777778
"Census Tract 9704, Sanilac County, Michigan",320,26,151,970400,298,22,6.875000000000001
"Census Tract 9704, Arenac County, Michigan",229,26,11,970400,215,14,6.11353711790393
"Census Tract 9704, Emmet County, Michigan",227,26,47,970400,221,6,2.643171806167401
"Census Tract 9704, Delta County, Michigan",202,26,41,970400,189,13,6.435643564356436
"Census Tract 9704, Newaygo County, Michigan",199,26,123,970400,195,4,2.0100502512562812
"Census Tract 9704, Osceola County, Michigan",436,26,133,970400,421,15,3.4403669724770642
"Census Tract 9704, Montcalm County, Michigan",316,26,117,970400,311,5,1.5822784810126582
"Census Tract 9704, Alcona County, Michigan",185,26,1,970400,172,13,7.027027027027027
"Census Tract 9704, Chippewa County, Michigan",296,26,33,970400,205,91,30.743243243243246
"Census Tract 9705, Delta County, Michigan",126,26,41,970500,126,0,0.0
"Census Tract 9705, Roscommon County, Michigan",28,26,143,970500,28,0,0.0
"Census Tract 9705, Montcalm County, Michigan",426,26,117,970500,417,9,2.112676056338028
"Census Tract 9705, Chippewa County, Michigan",621,26,33,970500,549,72,11.594202898550725
"Census Tract 9705, Newaygo County, Michigan",593,26,123,970500,521,72,12.141652613827993
"Census Tract 9705, Osceola County, Michigan",169,26,133,970500,159,10,5.9171597633136095
"Census Tract 9705, Leelanau County, Michigan",164,26,89,970500,134,30,18.29268292682927
"Census Tract 9705, Alcona County, Michigan",135,26,1,970500,135,0,0.0
"Census Tract 9705, Oscoda County, Michigan",117,26,135,970500,113,4,3.418803418803419
"Census Tract 9705, Emmet County, Michigan",495,26,47,970500,479,16,3.2323232323232323
"Census Tract 9705, Sanilac County, Michigan",171,26,151,970500,166,5,2.923976608187134
"Census Tract 9705, Arenac County, Michigan",474,26,11,970500,445,29,6.118143459915612
"Census Tract 9706, Newaygo County, Michigan",113,26,123,970600,113,0,0.0
"Census Tract 9706, Montcalm County, Michigan",284,26,117,970600,270,14,4.929577464788732
"Census Tract 9706, Sanilac County, Michigan",179,26,151,970600,165,14,7.82122905027933
"Census Tract 9706, Leelanau County, Michigan",275,26,89,970600,275,0,0.0
"Census Tract 9706, Alcona County, Michigan",61,26,1,970600,61,0,0.0
"Census Tract 9706, Delta County, Michigan",408,26,41,970600,317,91,22.30392156862745
"Census Tract 9706, Chippewa County, Michigan",452,26,33,970600,180,272,60.17699115044248
"Census Tract 9706, Osceola County, Michigan",522,26,133,970600,497,25,4.789272030651341
"Census Tract 9706, Roscommon County, Michigan",114,26,143,970600,114,0,0.0
"Census Tract 9706, Emmet County, Michigan",280,26,47,970600,280,0,0.0
"Census Tract 9707, Montcalm County, Michigan",415,26,117,970700,396,19,4.578313253012048
"Census Tract 9707, Sanilac County, Michigan",105,26,151,970700,105,0,0.0
"Census Tract 9707, Emmet County, Michigan",803,26,47,970700,768,35,4.35865504358655
"Census Tract 9707, Newaygo County, Michigan",315,26,123,970700,295,20,6.349206349206349
"Census Tract 9707, Chippewa County, Michigan",62,26,33,970700,55,7,11.29032258064516
"Census Tract 9707, Delta County, Michigan",217,26,41,970700,189,28,12.903225806451612
"Census Tract 9707, Roscommon County, Michigan",188,26,143,970700,188,0,0.0
"Census Tract 9708, Montcalm County, Michigan",388,26,117,970800,383,5,1.2886597938144329
"Census Tract 9708, Emmet County, Michigan",1296,26,47,970800,1131,165,12.731481481481483
"Census Tract 9708, Chippewa County, Michigan",216,26,33,970800,183,33,15.277777777777779
"Census Tract 9708, Delta County, Michigan",789,26,41,970800,724,65,8.238276299112801
"Census Tract 9708, Sanilac County, Michigan",569,26,151,970800,487,82,14.411247803163443
"Census Tract 9708, Newaygo County, Michigan",159,26,123,970800,144,15,9.433962264150944
"Census Tract 9709, Montcalm County, Michigan",225,26,117,970900,196,29,12.88888888888889
"Census Tract 9709, Sanilac County, Michigan",669,26,151,970900,595,74,11.061285500747383
"Census Tract 9709, Chippewa County, Michigan",695,26,33,970900,337,358,51.510791366906474
"Census Tract 9709, Newaygo County, Michigan",363,26,123,970900,358,5,1.3774104683195594
"Census Tract 9709, Delta County, Michigan",624,26,41,970900,593,31,4.967948717948718
"Census Tract 9710, Roscommon County, Michigan",285,26,143,971000,259,26,9.12280701754386
"Census Tract 9710, Delta County, Michigan",692,26,41,971000,692,0,0.0
"Census Tract 9710, Chippewa County, Michigan",138,26,33,971000,119,19,13.768115942028986
"Census Tract 9710, Montcalm County, Michigan",419,26,117,971000,406,13,3.1026252983293556
"Census Tract 9710, Sanilac County, Michigan",548,26,151,971000,497,51,9.306569343065693
"Census Tract 9710, Newaygo County, Michigan",168,26,123,971000,147,21,12.5
"Census Tract 9711, Chippewa County, Michigan",74,26,33,971100,69,5,6.756756756756757
"Census Tract 9711, Roscommon County, Michigan",254,26,143,971100,196,58,22.83464566929134
"Census Tract 9711, Sanilac County, Michigan",345,26,151,971100,293,52,15.072463768115943
"Census Tract 9711, Delta County, Michigan",295,26,41,971100,215,80,27.11864406779661
"Census Tract 9711, Newaygo County, Michigan",333,26,123,971100,286,47,14.114114114114114
"Census Tract 9711, Montcalm County, Michigan",366,26,117,971100,314,52,14.207650273224044
"Census Tract 9712, Roscommon County, Michigan",553,26,143,971200,505,48,8.679927667269439
"Census Tract 9712, Sanilac County, Michigan",348,26,151,971200,336,12,3.4482758620689653
"Census Tract 9712, Montcalm County, Michigan",620,26,117,971200,542,78,12.580645161290322
"Census Tract 9712, Newaygo County, Michigan",341,26,123,971200,271,70,20.527859237536656
"Census Tract 9713, Montcalm County, Michigan",885,26,117,971300,775,110,12.429378531073446
"Census Tract 9800, Ingham County, Michigan",4,26,65,980000,4,0,0.0
"Census Tract 9800, Luce County, Michigan",0,26,95,980000,0,0,
"Census Tract 9800, Genesee County, Michigan",10,26,49,980000,10,0,0.0
"Census Tract 9801, Chippewa County, Michigan",0,26,33,980100,0,0,
"Census Tract 9801, Keweenaw County, Michigan",0,26,83,980100,0,0,
"Census Tract 9801, Genesee County, Michigan",0,26,49,980100,0,0,
"Census Tract 9801, Ingham County, Michigan",0,26,65,980100,0,0,
"Census Tract 9802, Chippewa County, Michigan",0,26,33,980200,0,0,
"Census Tract 9802, Ingham County, Michigan",0,26,65,980200,0,0,
"Census Tract 9803, Ingham County, Michigan",0,26,65,980300,0,0,
"Census Tract 9803, Chippewa County, Michigan",0,26,33,980300,0,0,
"Census Tract 9810, Oakland County, Michigan",0,26,125,981000,0,0,
"Census Tract 9813, Mecosta County, Michigan",0,26,107,981300,0,0,
"Census Tract 9820, Macomb County, Michigan",4,26,99,982000,0,4,100.0
"Census Tract 9821, Macomb County, Michigan",0,26,99,982100,0,0,
"Census Tract 9822, Ionia County, Michigan",0,26,67,982200,0,0,
"Census Tract 9822, Macomb County, Michigan",0,26,99,982200,0,0,
"Census Tract 9823, Macomb County, Michigan",0,26,99,982300,0,0,
"Census Tract 9840, Washtenaw County, Michigan",0,26,161,984000,0,0,
"Census Tract 9850, Wayne County, Michigan",0,26,163,985000,0,0,
"Census Tract 9851, Wayne County, Michigan",146,26,163,985100,30,116,79.45205479452055
"Census Tract 9852, Wayne County, Michigan",0,26,163,985200,0,0,
"Census Tract 9853, Wayne County, Michigan",166,26,163,985300,85,81,48.795180722891565
"Census Tract 9854, Wayne County, Michigan",0,26,163,985400,0,0,
"Census Tract 9855, Wayne County, Michigan",0,26,163,985500,0,0,
"Census Tract 9856, Wayne County, Michigan",0,26,163,985600,0,0,
"Census Tract 9857, Wayne County, Michigan",0,26,163,985700,0,0,
"Census Tract 9859, Wayne County, Michigan",0,26,163,985900,0,0,
"Census Tract 9900, Arenac County, Michigan",0,26,11,990000,0,0,
"Census Tract 9900, Allegan County, Michigan",0,26,5,990000,0,0,
"Census Tract 9900, Alpena County, Michigan",0,26,7,990000,0,0,
"Census Tract 9900, Antrim County, Michigan",0,26,9,990000,0,0,
"Census Tract 9900, Marquette County, Michigan",0,26,103,990000,0,0,
"Census Tract 9900, Alcona County, Michigan",0,26,1,990000,0,0,
"Census Tract 9900, Tuscola County, Michigan",0,26,157,990000,0,0,
"Census Tract 9900, Bay County, Michigan",0,26,17,990000,0,0,
"Census Tract 9900, Luce County, Michigan",0,26,95,990000,0,0,
"Census Tract 9900, Mackinac County, Michigan",0,26,97,990000,0,0,
"Census Tract 9900, Alger County, Michigan",0,26,3,990000,0,0,
"Census Tract 9900, Iosco County, Michigan",0,26,69,990000,0,0,
"Census Tract 9900, Grand Traverse County, Michigan",0,26,55,990000,0,0,
"Census Tract 9900, Chippewa County, Michigan",0,26,33,990000,0,0,
"Census Tract 9900, Benzie County, Michigan",0,26,19,990000,0,0,
"Census Tract 9900, Menominee County, Michigan",0,26,109,990000,0,0,
"Census Tract 9900, Mason County, Michigan",0,26,105,990000,0,0,
"Census Tract 9900, Ottawa County, Michigan",0,26,139,990000,0,0,
"Census Tract 9900, Presque Isle County, Michigan",0,26,141,990000,0,0,
"Census Tract 9900, St. Clair County, Michigan",0,26,147,990000,0,0,
"Census Tract 9900, Delta County, Michigan",0,26,41,990000,0,0,
"Census Tract 9900, Sanilac County, Michigan",0,26,151,990000,0,0,
"Census Tract 9900, Oceana County, Michigan",0,26,127,990000,0,0,
"Census Tract 9900, Gogebic County, Michigan",0,26,53,990000,0,0,
"Census Tract 9900, Schoolcraft County, Michigan",0,26,153,990000,0,0,
"Census Tract 9900, Emmet County, Michigan",0,26,47,990000,0,0,
"Census Tract 9900, Cheboygan County, Michigan",0,26,31,990000,0,0,
"Census Tract 9900, Monroe County, Michigan",0,26,115,990000,0,0,
"Census Tract 9900, Charlevoix County, Michigan",0,26,29,990000,0,0,
"Census Tract 9900, Houghton County, Michigan",0,26,61,990000,0,0,
"Census Tract 9900, Muskegon County, Michigan",0,26,121,990000,0,0,
"Census Tract 9900, Leelanau County, Michigan",0,26,89,990000,0,0,
"Census Tract 9900, Van Buren County, Michigan",0,26,159,990000,0,0,
"Census Tract 9900, Manistee County, Michigan",0,26,101,990000,0,0,
"Census Tract 9900, Berrien County, Michigan",0,26,21,990000,0,0,
"Census Tract 9900, Huron County, Michigan",0,26,63,990000,0,0,
"Census Tract 9901, Houghton County, Michigan",0,26,61,990100,0,0,
"Census Tract 9901, Arenac County, Michigan",0,26,11,990100,0,0,
"Census Tract 9901, Delta County, Michigan",0,26,41,990100,0,0,
"Census Tract 9901, Ontonagon County, Michigan",0,26,131,990100,0,0,
"Census Tract 9901, Baraga County, Michigan",0,26,13,990100,0,0,
"Census Tract 9901, Keweenaw County, Michigan",0,26,83,990100,0,0,
"Census Tract 9901, Wayne County, Michigan",0,26,163,990100,0,0,
"Census Tract 9901, Macomb County, Michigan",0,26,99,990100,0,0,
"Census Tract 9901, Chippewa County, Michigan",0,26,33,990100,0,0,
"Census Tract 9902, Wayne County, Michigan",0,26,163,990200,0,0,
